id,date,dir,open_date,close_date,open_price,close_price,profit
200101-001,2001-01-05,1,2001-01-05 09:35:00,2001-01-05 10:20:00,5192,5140,-52
200101-002,2001-01-05,1,2001-01-05 12:15:00,2001-01-05 13:30:00,5200,5279,79
200101-003,2001-01-08,1,2001-01-08 11:05:00,2001-01-08 11:40:00,5348,5294,-54
200101-004,2001-01-08,1,2001-01-08 12:05:00,2001-01-08 12:45:00,5348,5294,-54
200101-005,2001-01-08,-1,2001-01-08 13:05:00,2001-01-08 13:30:00,5237,5174,63
200101-006,2001-01-09,1,2001-01-09 13:15:00,2001-01-09 13:30:00,5358,5410,52
200101-007,2001-01-10,1,2001-01-10 10:00:00,2001-01-10 10:25:00,5421,5366,-55
200101-008,2001-01-11,1,2001-01-11 11:00:00,2001-01-11 11:40:00,5490,5431,-59
200101-009,2001-01-11,-1,2001-01-11 12:05:00,2001-01-11 13:30:00,5358,5330,28
200101-010,2001-01-12,-1,2001-01-12 09:35:00,2001-01-12 13:25:00,5306,5330,-24
200101-011,2001-01-15,1,2001-01-15 13:20:00,2001-01-15 13:30:00,5378,5410,32
200101-012,2001-01-16,1,2001-01-16 09:10:00,2001-01-16 13:30:00,5430,5747,317
200101-013,2001-01-17,1,2001-01-17 10:10:00,2001-01-17 11:35:00,5813,5754,-59
200101-014,2001-01-17,1,2001-01-17 13:05:00,2001-01-17 13:30:00,5849,5830,-19
200101-015,2001-01-18,1,2001-01-18 10:30:00,2001-01-18 13:30:00,5888,5911,23
200101-016,2001-01-29,1,2001-01-29 10:55:00,2001-01-29 12:50:00,5960,5900,-60
200101-017,2001-01-30,-1,2001-01-30 11:30:00,2001-01-30 12:50:00,5649,5706,-57
200101-018,2001-01-31,1,2001-01-31 10:05:00,2001-01-31 11:40:00,5930,5870,-60
200101-019,2001-01-31,1,2001-01-31 12:55:00,2001-01-31 13:30:00,6000,5940,-60
200102-001,2001-02-01,-1,2001-02-01 12:45:00,2001-02-01 13:30:00,5880,5875,5
200102-002,2001-02-02,1,2001-02-02 09:35:00,2001-02-02 13:30:00,6020,6011,-9
200102-003,2001-02-05,-1,2001-02-05 09:55:00,2001-02-05 13:00:00,5911,5920,-9
200102-004,2001-02-06,-1,2001-02-06 12:25:00,2001-02-06 13:30:00,5860,5830,30
200102-005,2001-02-07,-1,2001-02-07 09:15:00,2001-02-07 13:30:00,5745,5700,45
200102-006,2001-02-09,1,2001-02-09 12:00:00,2001-02-09 13:30:00,5815,5792,-23
200102-007,2001-02-13,1,2001-02-13 09:10:00,2001-02-13 13:30:00,5929,6004,75
200102-008,2001-02-14,-1,2001-02-14 12:15:00,2001-02-14 13:30:00,5933,5860,73
200102-009,2001-02-15,1,2001-02-15 11:10:00,2001-02-15 13:30:00,6040,6118,78
200102-010,2001-02-16,-1,2001-02-16 10:55:00,2001-02-16 12:55:00,6007,6049,-42
200102-011,2001-02-19,-1,2001-02-19 09:10:00,2001-02-19 12:45:00,5890,5948,-58
200102-012,2001-02-20,-1,2001-02-20 13:20:00,2001-02-20 13:30:00,5920,5949,-29
200102-013,2001-02-21,-1,2001-02-21 09:15:00,2001-02-21 11:50:00,5835,5861,-26
200102-014,2001-02-22,-1,2001-02-22 09:30:00,2001-02-22 13:30:00,5805,5750,55
200102-015,2001-02-26,-1,2001-02-26 11:50:00,2001-02-26 13:30:00,5731,5734,-3
200102-016,2001-02-27,-1,2001-02-27 12:25:00,2001-02-27 13:30:00,5700,5670,30
200103-001,2001-03-01,-1,2001-03-01 09:10:00,2001-03-01 13:30:00,5563,5520,43
200103-002,2001-03-05,1,2001-03-05 11:30:00,2001-03-05 13:30:00,5565,5617,52
200103-003,2001-03-06,1,2001-03-06 10:45:00,2001-03-06 13:00:00,5684,5627,-57
200103-004,2001-03-06,-1,2001-03-06 13:05:00,2001-03-06 13:30:00,5619,5626,-7
200103-005,2001-03-07,1,2001-03-07 09:10:00,2001-03-07 13:30:00,5719,5748,29
200103-006,2001-03-09,-1,2001-03-09 09:55:00,2001-03-09 13:15:00,5630,5639,-9
200103-007,2001-03-13,1,2001-03-13 11:30:00,2001-03-13 13:30:00,5618,5618,0
200103-008,2001-03-15,1,2001-03-15 11:50:00,2001-03-15 13:30:00,5683,5759,76
200103-009,2001-03-16,1,2001-03-16 09:25:00,2001-03-16 13:30:00,5780,5760,-20
200103-010,2001-03-19,-1,2001-03-19 09:10:00,2001-03-19 13:30:00,5721,5627,94
200103-011,2001-03-22,1,2001-03-22 09:15:00,2001-03-22 13:30:00,5680,5735,55
200103-012,2001-03-26,1,2001-03-26 12:15:00,2001-03-26 13:30:00,5840,5900,60
200103-013,2001-03-27,1,2001-03-27 11:10:00,2001-03-27 12:55:00,5927,5867,-60
200103-014,2001-03-27,-1,2001-03-27 13:00:00,2001-03-27 13:30:00,5861,5870,-9
200103-015,2001-03-28,-1,2001-03-28 10:20:00,2001-03-28 13:25:00,5851,5854,-3
200103-016,2001-03-29,-1,2001-03-29 12:05:00,2001-03-29 12:50:00,5806,5844,-38
200103-017,2001-03-29,1,2001-03-29 13:10:00,2001-03-29 13:30:00,5859,5871,12
200103-018,2001-03-30,-1,2001-03-30 12:25:00,2001-03-30 13:30:00,5800,5778,22
200104-001,2001-04-02,-1,2001-04-02 09:15:00,2001-04-02 13:30:00,5753,5636,117
200104-002,2001-04-03,-1,2001-04-03 09:10:00,2001-04-03 13:30:00,5560,5487,73
200104-003,2001-04-09,-1,2001-04-09 09:10:00,2001-04-09 12:45:00,5432,5435,-3
200104-004,2001-04-10,-1,2001-04-10 12:55:00,2001-04-10 13:30:00,5411,5330,81
200104-005,2001-04-11,1,2001-04-11 13:10:00,2001-04-11 13:30:00,5475,5480,5
200104-006,2001-04-12,1,2001-04-12 12:00:00,2001-04-12 13:30:00,5540,5516,-24
200104-007,2001-04-13,-1,2001-04-13 11:05:00,2001-04-13 13:30:00,5505,5465,40
200104-008,2001-04-16,-1,2001-04-16 09:10:00,2001-04-16 13:30:00,5421,5425,-4
200104-009,2001-04-18,1,2001-04-18 10:40:00,2001-04-18 13:30:00,5515,5530,15
200104-010,2001-04-24,1,2001-04-24 09:15:00,2001-04-24 13:30:00,5647,5604,-43
200104-011,2001-04-25,-1,2001-04-25 09:15:00,2001-04-25 13:30:00,5593,5508,85
200104-012,2001-04-26,-1,2001-04-26 09:15:00,2001-04-26 12:30:00,5504,5511,-7
200104-013,2001-04-30,-1,2001-04-30 09:30:00,2001-04-30 10:10:00,5419,5474,-55
200105-001,2001-05-02,-1,2001-05-02 11:00:00,2001-05-02 13:30:00,5410,5348,62
200105-002,2001-05-04,-1,2001-05-04 11:10:00,2001-05-04 13:30:00,5355,5235,120
200105-003,2001-05-07,-1,2001-05-07 11:20:00,2001-05-07 11:40:00,5200,5252,-52
200105-004,2001-05-08,-1,2001-05-08 11:15:00,2001-05-08 13:30:00,5190,5224,-34
200105-005,2001-05-10,-1,2001-05-10 09:10:00,2001-05-10 13:30:00,5201,5162,39
200105-006,2001-05-11,-1,2001-05-11 10:30:00,2001-05-11 11:40:00,5080,5131,-51
200105-007,2001-05-11,1,2001-05-11 12:00:00,2001-05-11 13:30:00,5188,5249,61
200105-008,2001-05-16,-1,2001-05-16 09:10:00,2001-05-16 12:35:00,5144,5138,6
200105-009,2001-05-18,-1,2001-05-18 12:50:00,2001-05-18 13:30:00,5105,5074,31
200105-010,2001-05-21,-1,2001-05-21 09:10:00,2001-05-21 13:30:00,5055,4966,89
200105-011,2001-05-23,1,2001-05-23 09:40:00,2001-05-23 13:30:00,5068,5215,147
200105-012,2001-05-24,1,2001-05-24 09:10:00,2001-05-24 13:30:00,5226,5225,-1
200105-013,2001-05-28,-1,2001-05-28 09:10:00,2001-05-28 13:30:00,5136,5105,31
200105-014,2001-05-30,-1,2001-05-30 09:30:00,2001-05-30 13:10:00,5072,5090,-18
200106-001,2001-06-01,-1,2001-06-01 10:05:00,2001-06-01 13:30:00,5064,5044,20
200106-002,2001-06-05,1,2001-06-05 13:10:00,2001-06-05 13:30:00,5059,5083,24
200106-003,2001-06-06,1,2001-06-06 09:10:00,2001-06-06 13:30:00,5146,5212,66
200106-004,2001-06-07,-1,2001-06-07 09:30:00,2001-06-07 12:55:00,5160,5165,-5
200106-005,2001-06-08,1,2001-06-08 10:55:00,2001-06-08 13:20:00,5253,5200,-53
200106-006,2001-06-11,-1,2001-06-11 09:25:00,2001-06-11 11:55:00,5192,5218,-26
200106-007,2001-06-11,1,2001-06-11 13:20:00,2001-06-11 13:30:00,5259,5270,11
200106-008,2001-06-13,-1,2001-06-13 09:10:00,2001-06-13 10:20:00,5225,5278,-53
200106-009,2001-06-13,-1,2001-06-13 12:15:00,2001-06-13 13:30:00,5220,5189,31
200106-010,2001-06-14,-1,2001-06-14 09:20:00,2001-06-14 13:30:00,5150,5133,17
200106-011,2001-06-18,-1,2001-06-18 09:15:00,2001-06-18 13:10:00,5105,5100,5
200106-012,2001-06-20,-1,2001-06-20 10:40:00,2001-06-20 13:10:00,5051,5065,-14
200106-013,2001-06-21,-1,2001-06-21 10:40:00,2001-06-21 13:30:00,5037,4990,47
200106-014,2001-06-22,-1,2001-06-22 12:05:00,2001-06-22 13:30:00,4960,4955,5
200106-015,2001-06-26,-1,2001-06-26 10:15:00,2001-06-26 13:30:00,4931,4841,90
200106-016,2001-06-27,-1,2001-06-27 12:25:00,2001-06-27 13:30:00,4830,4865,-35
200106-017,2001-06-28,-1,2001-06-28 09:55:00,2001-06-28 13:25:00,4805,4828,-23
200106-018,2001-06-29,1,2001-06-29 09:10:00,2001-06-29 13:30:00,4890,4895,5
200107-001,2001-07-02,-1,2001-07-02 09:15:00,2001-07-02 12:50:00,4867,4857,10
200107-002,2001-07-02,1,2001-07-02 13:15:00,2001-07-02 13:30:00,4920,4925,5
200107-003,2001-07-04,-1,2001-07-04 09:15:00,2001-07-04 13:20:00,4795,4783,12
200107-004,2001-07-09,-1,2001-07-09 10:25:00,2001-07-09 12:45:00,4708,4734,-26
200107-005,2001-07-11,-1,2001-07-11 09:10:00,2001-07-11 13:30:00,4627,4590,37
200107-006,2001-07-12,1,2001-07-12 12:25:00,2001-07-12 13:30:00,4668,4665,-3
200107-007,2001-07-13,-1,2001-07-13 11:00:00,2001-07-13 13:30:00,4641,4481,160
200107-008,2001-07-16,-1,2001-07-16 10:35:00,2001-07-16 13:30:00,4446,4396,50
200107-009,2001-07-18,-1,2001-07-18 10:25:00,2001-07-18 13:30:00,4262,4176,86
200107-010,2001-07-19,-1,2001-07-19 11:20:00,2001-07-19 12:40:00,4115,4157,-42
200107-011,2001-07-23,-1,2001-07-23 12:45:00,2001-07-23 13:30:00,4125,4122,3
200107-012,2001-07-24,-1,2001-07-24 09:10:00,2001-07-24 13:30:00,4074,4050,24
200107-013,2001-07-26,1,2001-07-26 10:40:00,2001-07-26 13:30:00,4152,4290,138
200107-014,2001-07-27,1,2001-07-27 09:10:00,2001-07-27 09:30:00,4295,4252,-43
200107-015,2001-07-27,1,2001-07-27 10:45:00,2001-07-27 13:30:00,4295,4252,-43
200107-016,2001-07-31,-1,2001-07-31 09:15:00,2001-07-31 10:05:00,4235,4278,-43
200108-001,2001-08-02,1,2001-08-02 09:40:00,2001-08-02 13:30:00,4333,4433,100
200108-002,2001-08-03,1,2001-08-03 11:00:00,2001-08-03 13:30:00,4480,4480,0
200108-003,2001-08-06,-1,2001-08-06 10:25:00,2001-08-06 13:30:00,4446,4420,26
200108-004,2001-08-07,-1,2001-08-07 09:10:00,2001-08-07 13:05:00,4373,4368,5
200108-005,2001-08-08,1,2001-08-08 09:55:00,2001-08-08 13:30:00,4443,4488,45
200108-006,2001-08-09,-1,2001-08-09 11:50:00,2001-08-09 12:50:00,4432,4477,-45
200108-007,2001-08-10,-1,2001-08-10 09:10:00,2001-08-10 12:20:00,4403,4405,-2
200108-008,2001-08-10,1,2001-08-10 13:20:00,2001-08-10 13:30:00,4490,4468,-22
200108-009,2001-08-13,1,2001-08-13 09:45:00,2001-08-13 13:30:00,4510,4480,-30
200108-010,2001-08-14,1,2001-08-14 12:55:00,2001-08-14 13:30:00,4550,4587,37
200108-011,2001-08-15,1,2001-08-15 09:45:00,2001-08-15 13:30:00,4619,4606,-13
200108-012,2001-08-16,1,2001-08-16 10:20:00,2001-08-16 12:05:00,4658,4611,-47
200108-013,2001-08-17,-1,2001-08-17 10:10:00,2001-08-17 13:30:00,4596,4607,-11
200108-014,2001-08-22,-1,2001-08-22 13:05:00,2001-08-22 13:30:00,4514,4483,31
200108-015,2001-08-23,-1,2001-08-23 10:25:00,2001-08-23 11:50:00,4445,4490,-45
200108-016,2001-08-23,-1,2001-08-23 13:15:00,2001-08-23 13:30:00,4445,4455,-10
200108-017,2001-08-24,-1,2001-08-24 09:10:00,2001-08-24 13:30:00,4435,4295,140
200108-018,2001-08-28,-1,2001-08-28 10:30:00,2001-08-28 12:25:00,4305,4338,-33
200108-019,2001-08-29,1,2001-08-29 10:50:00,2001-08-29 13:30:00,4374,4470,96
200108-020,2001-08-30,1,2001-08-30 09:35:00,2001-08-30 12:20:00,4491,4446,-45
200108-021,2001-08-31,-1,2001-08-31 09:15:00,2001-08-31 12:00:00,4385,4414,-29
200109-001,2001-09-03,-1,2001-09-03 13:00:00,2001-09-03 13:30:00,4410,4390,20
200109-002,2001-09-04,-1,2001-09-04 09:15:00,2001-09-04 10:35:00,4360,4404,-44
200109-003,2001-09-05,-1,2001-09-05 11:05:00,2001-09-05 13:30:00,4393,4370,23
200109-004,2001-09-06,-1,2001-09-06 09:20:00,2001-09-06 13:30:00,4353,4319,34
200109-005,2001-09-07,-1,2001-09-07 10:15:00,2001-09-07 13:00:00,4255,4278,-23
200109-006,2001-09-10,-1,2001-09-10 09:20:00,2001-09-10 12:15:00,4237,4267,-30
200109-007,2001-09-10,1,2001-09-10 13:05:00,2001-09-10 13:30:00,4294,4267,-27
200109-008,2001-09-11,-1,2001-09-11 09:55:00,2001-09-11 13:30:00,4236,4162,74
200109-009,2001-09-14,-1,2001-09-14 10:25:00,2001-09-14 13:30:00,3850,3700,150
200109-010,2001-09-20,-1,2001-09-20 10:20:00,2001-09-20 11:05:00,3583,3619,-36
200109-011,2001-09-20,-1,2001-09-20 12:25:00,2001-09-20 13:30:00,3581,3562,19
200109-012,2001-09-21,-1,2001-09-21 09:10:00,2001-09-21 13:30:00,3440,3427,13
200109-013,2001-09-24,-1,2001-09-24 11:05:00,2001-09-24 11:45:00,3400,3434,-34
200109-014,2001-09-24,1,2001-09-24 12:45:00,2001-09-24 12:50:00,3543,3507,-36
200109-015,2001-09-25,-1,2001-09-25 12:30:00,2001-09-25 13:30:00,3490,3425,65
200109-016,2001-09-26,-1,2001-09-26 10:10:00,2001-09-26 10:20:00,3408,3443,-35
200109-017,2001-09-27,-1,2001-09-27 10:35:00,2001-09-27 10:50:00,3520,3556,-36
200109-018,2001-09-28,1,2001-09-28 09:30:00,2001-09-28 09:55:00,3657,3620,-37
200110-001,2001-10-02,-1,2001-10-02 09:10:00,2001-10-02 13:30:00,3571,3437,134
200110-002,2001-10-09,1,2001-10-09 11:25:00,2001-10-09 13:30:00,3577,3611,34
200110-003,2001-10-11,1,2001-10-11 09:15:00,2001-10-11 13:30:00,3718,3825,107
200110-004,2001-10-12,-1,2001-10-12 11:00:00,2001-10-12 11:20:00,3792,3830,-38
200110-005,2001-10-15,-1,2001-10-15 10:30:00,2001-10-15 13:30:00,3740,3734,6
200110-006,2001-10-16,1,2001-10-16 13:10:00,2001-10-16 13:30:00,3773,3795,22
200110-007,2001-10-17,1,2001-10-17 09:40:00,2001-10-17 10:50:00,3845,3806,-39
200110-008,2001-10-17,1,2001-10-17 12:50:00,2001-10-17 13:25:00,3855,3816,-39
200110-009,2001-10-18,-1,2001-10-18 09:15:00,2001-10-18 10:15:00,3715,3753,-38
200110-010,2001-10-19,-1,2001-10-19 09:20:00,2001-10-19 10:25:00,3726,3764,-38
200110-011,2001-10-19,1,2001-10-19 11:30:00,2001-10-19 12:35:00,3819,3780,-39
200110-012,2001-10-19,1,2001-10-19 13:15:00,2001-10-19 13:30:00,3835,3823,-12
200110-013,2001-10-22,1,2001-10-22 09:25:00,2001-10-22 13:30:00,3869,3885,16
200110-014,2001-10-23,-1,2001-10-23 12:30:00,2001-10-23 13:30:00,3858,3852,6
200110-015,2001-10-24,1,2001-10-24 12:00:00,2001-10-24 13:30:00,3946,3957,11
200110-016,2001-10-26,1,2001-10-26 09:10:00,2001-10-26 13:20:00,4029,3988,-41
200110-017,2001-10-29,-1,2001-10-29 09:30:00,2001-10-29 12:35:00,3973,4009,-36
200110-018,2001-10-30,-1,2001-10-30 09:10:00,2001-10-30 13:30:00,3920,3858,62
200110-019,2001-10-31,-1,2001-10-31 12:50:00,2001-10-31 13:30:00,3826,3845,-19
200111-001,2001-11-02,1,2001-11-02 09:10:00,2001-11-02 13:30:00,3935,3933,-2
200111-002,2001-11-05,1,2001-11-05 13:05:00,2001-11-05 13:30:00,3973,4020,47
200111-003,2001-11-06,1,2001-11-06 12:30:00,2001-11-06 13:05:00,4078,4037,-41
200111-004,2001-11-09,-1,2001-11-09 09:20:00,2001-11-09 12:15:00,4005,4031,-26
200111-005,2001-11-12,1,2001-11-12 12:20:00,2001-11-12 13:30:00,4060,4076,16
200111-006,2001-11-14,1,2001-11-14 09:55:00,2001-11-14 13:30:00,4144,4236,92
200111-007,2001-11-15,1,2001-11-15 10:00:00,2001-11-15 13:30:00,4279,4349,70
200111-008,2001-11-16,1,2001-11-16 11:35:00,2001-11-16 13:30:00,4380,4406,26
200111-009,2001-11-19,1,2001-11-19 11:25:00,2001-11-19 13:30:00,4472,4553,81
200111-010,2001-11-20,-1,2001-11-20 12:40:00,2001-11-20 13:30:00,4511,4450,61
200111-011,2001-11-21,-1,2001-11-21 09:15:00,2001-11-21 10:00:00,4410,4455,-45
200111-012,2001-11-22,-1,2001-11-22 10:50:00,2001-11-22 13:30:00,4433,4411,22
200111-013,2001-11-26,1,2001-11-26 09:45:00,2001-11-26 13:30:00,4585,4602,17
200111-014,2001-11-27,-1,2001-11-27 10:25:00,2001-11-27 13:30:00,4575,4531,44
200111-015,2001-11-28,-1,2001-11-28 12:35:00,2001-11-28 13:30:00,4484,4398,86
200111-016,2001-11-30,1,2001-11-30 12:00:00,2001-11-30 13:10:00,4446,4401,-45
200112-001,2001-12-03,1,2001-12-03 09:10:00,2001-12-03 13:30:00,4465,4593,128
200112-002,2001-12-04,1,2001-12-04 10:15:00,2001-12-04 13:30:00,4600,4731,131
200112-003,2001-12-05,1,2001-12-05 10:00:00,2001-12-05 13:30:00,4840,4900,60
200112-004,2001-12-06,1,2001-12-06 09:30:00,2001-12-06 13:30:00,5060,5253,193
200112-005,2001-12-07,1,2001-12-07 10:10:00,2001-12-07 11:25:00,5290,5237,-53
200112-006,2001-12-07,1,2001-12-07 13:20:00,2001-12-07 13:30:00,5310,5360,50
200112-007,2001-12-10,1,2001-12-10 12:50:00,2001-12-10 13:00:00,5420,5365,-55
200112-008,2001-12-11,-1,2001-12-11 09:15:00,2001-12-11 10:05:00,5225,5278,-53
200112-009,2001-12-12,1,2001-12-12 10:30:00,2001-12-12 13:30:00,5420,5652,232
200112-010,2001-12-13,-1,2001-12-13 12:35:00,2001-12-13 13:30:00,5489,5411,78
200112-011,2001-12-18,-1,2001-12-18 10:35:00,2001-12-18 13:30:00,5385,5350,35
200112-012,2001-12-19,-1,2001-12-19 12:25:00,2001-12-19 13:30:00,5280,5220,60
200112-013,2001-12-21,-1,2001-12-21 09:10:00,2001-12-21 13:30:00,5192,5061,131
200112-014,2001-12-25,1,2001-12-25 10:25:00,2001-12-25 13:30:00,5260,5429,169
200112-015,2001-12-26,-1,2001-12-26 11:25:00,2001-12-26 12:25:00,5331,5385,-54
200112-016,2001-12-27,-1,2001-12-27 11:45:00,2001-12-27 13:30:00,5331,5250,81
200112-017,2001-12-31,1,2001-12-31 09:10:00,2001-12-31 13:30:00,5490,5567,77
200201-001,2002-01-02,1,2002-01-02 13:05:00,2002-01-02 13:30:00,5615,5606,-9
200201-002,2002-01-07,1,2002-01-07 11:20:00,2002-01-07 13:30:00,5718,5825,107
200201-003,2002-01-08,-1,2002-01-08 12:55:00,2002-01-08 13:30:00,5750,5808,-58
200201-004,2002-01-09,1,2002-01-09 09:55:00,2002-01-09 12:10:00,5870,5811,-59
200201-005,2002-01-09,-1,2002-01-09 12:35:00,2002-01-09 13:25:00,5761,5819,-58
200201-006,2002-01-11,-1,2002-01-11 11:50:00,2002-01-11 13:30:00,5759,5641,118
200201-007,2002-01-14,-1,2002-01-14 09:15:00,2002-01-14 13:30:00,5579,5574,5
200201-008,2002-01-15,-1,2002-01-15 11:15:00,2002-01-15 13:15:00,5523,5560,-37
200201-009,2002-01-18,1,2002-01-18 10:45:00,2002-01-18 12:00:00,5545,5489,-56
200201-010,2002-01-18,-1,2002-01-18 13:10:00,2002-01-18 13:30:00,5441,5435,6
200201-011,2002-01-21,1,2002-01-21 09:40:00,2002-01-21 13:30:00,5545,5824,279
200201-012,2002-01-22,-1,2002-01-22 10:55:00,2002-01-22 12:55:00,5767,5825,-58
200201-013,2002-01-29,-1,2002-01-29 09:55:00,2002-01-29 13:30:00,5906,5830,76
200201-014,2002-01-31,1,2002-01-31 13:05:00,2002-01-31 13:30:00,5855,5838,-17
200202-001,2002-02-01,-1,2002-02-01 13:20:00,2002-02-01 13:30:00,5831,5840,-9
200202-002,2002-02-04,-1,2002-02-04 09:15:00,2002-02-04 09:45:00,5785,5843,-58
200202-003,2002-02-06,1,2002-02-06 09:10:00,2002-02-06 13:30:00,5907,5955,48
200202-004,2002-02-18,-1,2002-02-18 13:20:00,2002-02-18 13:30:00,5970,5955,15
200202-005,2002-02-19,-1,2002-02-19 09:10:00,2002-02-19 13:30:00,5942,5850,92
200202-006,2002-02-20,-1,2002-02-20 09:45:00,2002-02-20 13:30:00,5781,5680,101
200202-007,2002-02-21,-1,2002-02-21 09:30:00,2002-02-21 13:30:00,5662,5639,23
200202-008,2002-02-22,-1,2002-02-22 09:20:00,2002-02-22 12:00:00,5560,5594,-34
200202-009,2002-02-25,-1,2002-02-25 11:15:00,2002-02-25 13:30:00,5560,5509,51
200202-010,2002-02-26,-1,2002-02-26 13:10:00,2002-02-26 13:30:00,5509,5500,9
200202-011,2002-02-27,1,2002-02-27 09:35:00,2002-02-27 13:30:00,5618,5692,74
200203-001,2002-03-04,1,2002-03-04 09:15:00,2002-03-04 13:30:00,5818,5918,100
200203-002,2002-03-05,-1,2002-03-05 11:45:00,2002-03-05 13:30:00,5896,5939,-43
200203-003,2002-03-06,1,2002-03-06 12:45:00,2002-03-06 13:30:00,6029,6115,86
200203-004,2002-03-08,-1,2002-03-08 11:50:00,2002-03-08 13:30:00,6053,6011,42
200203-005,2002-03-11,1,2002-03-11 11:15:00,2002-03-11 13:30:00,6185,6196,11
200203-006,2002-03-12,-1,2002-03-12 09:40:00,2002-03-12 13:30:00,6131,6112,19
200203-007,2002-03-13,-1,2002-03-13 11:40:00,2002-03-13 13:30:00,6072,6070,2
200203-008,2002-03-15,1,2002-03-15 09:30:00,2002-03-15 10:20:00,6105,6043,-62
200203-009,2002-03-15,-1,2002-03-15 11:20:00,2002-03-15 13:30:00,6011,5918,93
200203-010,2002-03-18,-1,2002-03-18 09:15:00,2002-03-18 12:35:00,5899,5945,-46
200203-011,2002-03-20,1,2002-03-20 10:35:00,2002-03-20 13:30:00,5970,6069,99
200203-012,2002-03-22,1,2002-03-22 09:15:00,2002-03-22 13:30:00,6145,6155,10
200203-013,2002-03-25,1,2002-03-25 11:55:00,2002-03-25 13:30:00,6185,6188,3
200203-014,2002-03-26,1,2002-03-26 13:10:00,2002-03-26 13:30:00,6209,6202,-7
200203-015,2002-03-27,1,2002-03-27 09:20:00,2002-03-27 10:30:00,6240,6177,-63
200203-016,2002-03-27,-1,2002-03-27 10:55:00,2002-03-27 13:30:00,6156,6090,66
200203-017,2002-03-28,-1,2002-03-28 10:05:00,2002-03-28 10:40:00,6065,6126,-61
200204-001,2002-04-02,1,2002-04-02 09:10:00,2002-04-02 13:30:00,6180,6211,31
200204-002,2002-04-04,-1,2002-04-04 09:55:00,2002-04-04 13:30:00,6168,6151,17
200204-003,2002-04-09,-1,2002-04-09 09:45:00,2002-04-09 13:30:00,6098,6037,61
200204-004,2002-04-10,-1,2002-04-10 09:20:00,2002-04-10 13:30:00,5991,6004,-13
200204-005,2002-04-12,-1,2002-04-12 09:10:00,2002-04-12 11:10:00,5980,6036,-56
200204-006,2002-04-12,1,2002-04-12 12:05:00,2002-04-12 13:30:00,6085,6161,76
200204-007,2002-04-15,1,2002-04-15 09:30:00,2002-04-15 13:30:00,6178,6169,-9
200204-008,2002-04-17,1,2002-04-17 12:25:00,2002-04-17 13:30:00,6385,6400,15
200204-009,2002-04-24,1,2002-04-24 11:20:00,2002-04-24 13:30:00,6417,6415,-2
200204-010,2002-04-25,-1,2002-04-25 09:25:00,2002-04-25 13:30:00,6343,6325,18
200204-011,2002-04-26,-1,2002-04-26 09:10:00,2002-04-26 13:30:00,6298,6293,5
200204-012,2002-04-29,-1,2002-04-29 09:15:00,2002-04-29 13:30:00,6235,6200,35
200204-013,2002-04-30,-1,2002-04-30 11:55:00,2002-04-30 13:30:00,6093,6084,9
200205-001,2002-05-02,-1,2002-05-02 09:20:00,2002-05-02 13:30:00,6050,5880,170
200205-002,2002-05-06,-1,2002-05-06 09:20:00,2002-05-06 13:30:00,5780,5624,156
200205-003,2002-05-08,1,2002-05-08 11:25:00,2002-05-08 13:00:00,5760,5702,-58
200205-004,2002-05-08,-1,2002-05-08 13:10:00,2002-05-08 13:30:00,5650,5707,-57
200205-005,2002-05-10,-1,2002-05-10 09:10:00,2002-05-10 10:50:00,5705,5763,-58
200205-006,2002-05-10,1,2002-05-10 13:10:00,2002-05-10 13:30:00,5830,5837,7
200205-007,2002-05-15,1,2002-05-15 09:40:00,2002-05-15 11:50:00,5893,5834,-59
200205-008,2002-05-15,1,2002-05-15 13:10:00,2002-05-15 13:30:00,5924,5930,6
200205-009,2002-05-16,-1,2002-05-16 11:00:00,2002-05-16 13:30:00,5842,5797,45
200205-010,2002-05-20,-1,2002-05-20 09:15:00,2002-05-20 13:30:00,5662,5538,124
200205-011,2002-05-21,-1,2002-05-21 09:55:00,2002-05-21 13:30:00,5468,5404,64
200205-012,2002-05-22,-1,2002-05-22 11:10:00,2002-05-22 11:40:00,5382,5436,-54
200205-013,2002-05-22,1,2002-05-22 13:15:00,2002-05-22 13:30:00,5505,5516,11
200205-014,2002-05-23,1,2002-05-23 09:15:00,2002-05-23 13:30:00,5525,5515,-10
200205-015,2002-05-24,1,2002-05-24 09:30:00,2002-05-24 13:30:00,5614,5688,74
200205-016,2002-05-28,-1,2002-05-28 10:10:00,2002-05-28 13:30:00,5666,5640,26
200205-017,2002-05-29,-1,2002-05-29 09:10:00,2002-05-29 12:15:00,5566,5569,-3
200205-018,2002-05-30,1,2002-05-30 09:25:00,2002-05-30 13:30:00,5675,5695,20
200206-001,2002-06-03,-1,2002-06-03 10:05:00,2002-06-03 13:30:00,5481,5505,-24
200206-002,2002-06-05,1,2002-06-05 09:10:00,2002-06-05 13:30:00,5605,5594,-11
200206-003,2002-06-06,-1,2002-06-06 09:10:00,2002-06-06 10:10:00,5562,5618,-56
200206-004,2002-06-11,-1,2002-06-11 11:05:00,2002-06-11 13:30:00,5388,5378,10
200206-005,2002-06-13,1,2002-06-13 09:30:00,2002-06-13 13:30:00,5498,5581,83
200206-006,2002-06-18,-1,2002-06-18 13:15:00,2002-06-18 13:30:00,5552,5567,-15
200206-007,2002-06-19,-1,2002-06-19 09:20:00,2002-06-19 13:30:00,5522,5380,142
200206-008,2002-06-20,-1,2002-06-20 09:10:00,2002-06-20 12:25:00,5330,5363,-33
200206-009,2002-06-21,1,2002-06-21 10:50:00,2002-06-21 13:30:00,5440,5433,-7
200206-010,2002-06-24,-1,2002-06-24 09:45:00,2002-06-24 12:20:00,5351,5390,-39
200206-011,2002-06-26,-1,2002-06-26 09:10:00,2002-06-26 13:30:00,5224,5102,122
200206-012,2002-06-27,-1,2002-06-27 10:25:00,2002-06-27 11:25:00,5082,5133,-51
200207-001,2002-07-01,-1,2002-07-01 09:10:00,2002-07-01 13:30:00,5060,4940,120
200207-002,2002-07-03,-1,2002-07-03 09:10:00,2002-07-03 10:50:00,4850,4899,-49
200207-003,2002-07-03,1,2002-07-03 11:35:00,2002-07-03 13:30:00,4985,5035,50
200207-004,2002-07-04,1,2002-07-04 09:30:00,2002-07-04 13:30:00,5070,5090,20
200207-005,2002-07-05,1,2002-07-05 11:40:00,2002-07-05 13:30:00,5137,5189,52
200207-006,2002-07-08,1,2002-07-08 09:55:00,2002-07-08 13:30:00,5294,5285,-9
200207-007,2002-07-09,-1,2002-07-09 09:35:00,2002-07-09 12:20:00,5260,5294,-34
200207-008,2002-07-10,-1,2002-07-10 09:25:00,2002-07-10 13:30:00,5215,5199,16
200207-009,2002-07-12,1,2002-07-12 09:15:00,2002-07-12 13:30:00,5250,5400,150
200207-010,2002-07-16,-1,2002-07-16 09:35:00,2002-07-16 13:30:00,5335,5297,38
200207-011,2002-07-17,-1,2002-07-17 09:35:00,2002-07-17 13:15:00,5250,5225,25
200207-012,2002-07-22,-1,2002-07-22 12:10:00,2002-07-22 13:30:00,5027,5023,4
200207-013,2002-07-23,1,2002-07-23 12:35:00,2002-07-23 13:30:00,5090,5169,79
200207-014,2002-07-24,-1,2002-07-24 10:50:00,2002-07-24 13:30:00,5030,5031,-1
200207-015,2002-07-25,-1,2002-07-25 13:00:00,2002-07-25 13:30:00,5066,5046,20
200207-016,2002-07-26,-1,2002-07-26 09:25:00,2002-07-26 13:30:00,4860,4750,110
200207-017,2002-07-29,1,2002-07-29 11:30:00,2002-07-29 12:15:00,4912,4862,-50
200207-018,2002-07-30,1,2002-07-30 09:10:00,2002-07-30 10:55:00,4976,4926,-50
200207-019,2002-07-31,-1,2002-07-31 10:10:00,2002-07-31 13:30:00,4904,4896,8
200208-001,2002-08-02,-1,2002-08-02 09:15:00,2002-08-02 11:45:00,4780,4828,-48
200208-002,2002-08-05,-1,2002-08-05 09:20:00,2002-08-05 13:30:00,4712,4576,136
200208-003,2002-08-07,1,2002-08-07 09:10:00,2002-08-07 13:30:00,4674,4668,-6
200208-004,2002-08-08,-1,2002-08-08 09:25:00,2002-08-08 11:25:00,4620,4667,-47
200208-005,2002-08-08,1,2002-08-08 12:10:00,2002-08-08 13:00:00,4697,4650,-47
200208-006,2002-08-09,1,2002-08-09 09:15:00,2002-08-09 13:30:00,4767,4771,4
200208-007,2002-08-14,1,2002-08-14 10:10:00,2002-08-14 13:30:00,4805,4856,51
200208-008,2002-08-15,1,2002-08-15 09:10:00,2002-08-15 13:30:00,4945,4895,-50
200208-009,2002-08-16,-1,2002-08-16 09:45:00,2002-08-16 13:30:00,4890,4895,-5
200208-010,2002-08-19,-1,2002-08-19 11:55:00,2002-08-19 13:30:00,4854,4866,-12
200208-011,2002-08-21,-1,2002-08-21 09:20:00,2002-08-21 12:40:00,4862,4868,-6
200208-012,2002-08-22,1,2002-08-22 09:30:00,2002-08-22 13:30:00,4928,4944,16
200208-013,2002-08-23,1,2002-08-23 09:40:00,2002-08-23 13:15:00,5010,4959,-51
200208-014,2002-08-26,-1,2002-08-26 09:55:00,2002-08-26 12:55:00,4883,4907,-24
200208-015,2002-08-27,-1,2002-08-27 11:10:00,2002-08-27 13:30:00,4881,4871,10
200208-016,2002-08-28,-1,2002-08-28 11:35:00,2002-08-28 13:30:00,4790,4771,19
200208-017,2002-08-29,1,2002-08-29 13:10:00,2002-08-29 13:30:00,4815,4801,-14
200209-001,2002-09-02,-1,2002-09-02 09:10:00,2002-09-02 13:30:00,4716,4618,98
200209-002,2002-09-03,-1,2002-09-03 09:20:00,2002-09-03 13:30:00,4611,4569,42
200209-003,2002-09-05,-1,2002-09-05 11:35:00,2002-09-05 13:30:00,4493,4453,40
200209-004,2002-09-09,-1,2002-09-09 09:10:00,2002-09-09 09:30:00,4440,4485,-45
200209-005,2002-09-10,1,2002-09-10 09:55:00,2002-09-10 13:30:00,4544,4647,103
200209-006,2002-09-11,1,2002-09-11 09:15:00,2002-09-11 13:30:00,4662,4654,-8
200209-007,2002-09-12,-1,2002-09-12 12:00:00,2002-09-12 13:30:00,4620,4624,-4
200209-008,2002-09-13,-1,2002-09-13 09:10:00,2002-09-13 13:30:00,4543,4554,-11
200209-009,2002-09-16,-1,2002-09-16 09:35:00,2002-09-16 13:30:00,4515,4419,96
200209-010,2002-09-17,1,2002-09-17 10:35:00,2002-09-17 13:30:00,4558,4650,92
200209-011,2002-09-18,-1,2002-09-18 09:15:00,2002-09-18 13:30:00,4498,4475,23
200209-012,2002-09-23,-1,2002-09-23 10:00:00,2002-09-23 13:30:00,4322,4300,22
200209-013,2002-09-24,-1,2002-09-24 11:35:00,2002-09-24 12:15:00,4265,4308,-43
200209-014,2002-09-25,-1,2002-09-25 11:40:00,2002-09-25 13:30:00,4213,4160,53
200209-015,2002-09-27,-1,2002-09-27 11:55:00,2002-09-27 13:30:00,4189,4179,10
200209-016,2002-09-30,-1,2002-09-30 09:20:00,2002-09-30 12:35:00,4086,4083,3
200210-001,2002-10-01,1,2002-10-01 09:45:00,2002-10-01 10:30:00,4190,4148,-42
200210-002,2002-10-01,-1,2002-10-01 12:25:00,2002-10-01 13:05:00,4080,4121,-41
200210-003,2002-10-03,-1,2002-10-03 09:50:00,2002-10-03 13:30:00,4059,4037,22
200210-004,2002-10-04,-1,2002-10-04 09:50:00,2002-10-04 10:05:00,4007,4048,-41
200210-005,2002-10-07,-1,2002-10-07 09:35:00,2002-10-07 13:30:00,3964,3900,64
200210-006,2002-10-08,-1,2002-10-08 09:50:00,2002-10-08 10:25:00,3888,3927,-39
200210-007,2002-10-08,1,2002-10-08 13:15:00,2002-10-08 13:30:00,3964,3953,-11
200210-008,2002-10-09,-1,2002-10-09 13:15:00,2002-10-09 13:30:00,3922,3896,26
200210-009,2002-10-11,-1,2002-10-11 12:05:00,2002-10-11 13:30:00,3842,3808,34
200210-010,2002-10-15,1,2002-10-15 09:10:00,2002-10-15 13:30:00,3975,4151,176
200210-011,2002-10-17,1,2002-10-17 10:25:00,2002-10-17 13:10:00,4245,4202,-43
200210-012,2002-10-18,1,2002-10-18 09:55:00,2002-10-18 10:20:00,4349,4305,-44
200210-013,2002-10-18,1,2002-10-18 12:05:00,2002-10-18 13:30:00,4355,4427,72
200210-014,2002-10-22,-1,2002-10-22 12:10:00,2002-10-22 13:30:00,4338,4308,30
200210-015,2002-10-23,-1,2002-10-23 09:35:00,2002-10-23 10:10:00,4287,4330,-43
200210-016,2002-10-23,1,2002-10-23 11:40:00,2002-10-23 13:30:00,4438,4579,141
200210-017,2002-10-29,-1,2002-10-29 10:10:00,2002-10-29 12:50:00,4501,4535,-34
200210-018,2002-10-30,-1,2002-10-30 11:30:00,2002-10-30 13:30:00,4493,4425,68
200210-019,2002-10-31,1,2002-10-31 09:30:00,2002-10-31 11:05:00,4568,4522,-46
200211-001,2002-11-01,-1,2002-11-01 11:50:00,2002-11-01 13:30:00,4461,4454,7
200211-002,2002-11-05,-1,2002-11-05 11:15:00,2002-11-05 12:45:00,4516,4554,-38
200211-003,2002-11-06,1,2002-11-06 11:20:00,2002-11-06 13:30:00,4623,4732,109
200211-004,2002-11-08,1,2002-11-08 10:55:00,2002-11-08 13:30:00,4773,4769,-4
200211-005,2002-11-11,-1,2002-11-11 09:45:00,2002-11-11 13:30:00,4712,4673,39
200211-006,2002-11-13,-1,2002-11-13 12:40:00,2002-11-13 13:25:00,4613,4660,-47
200211-007,2002-11-14,1,2002-11-14 09:20:00,2002-11-14 13:30:00,4693,4665,-28
200211-008,2002-11-15,1,2002-11-15 10:45:00,2002-11-15 13:30:00,4779,4799,20
200211-009,2002-11-19,-1,2002-11-19 09:50:00,2002-11-19 13:30:00,4750,4733,17
200211-010,2002-11-20,-1,2002-11-20 09:20:00,2002-11-20 12:35:00,4711,4678,33
200211-011,2002-11-21,-1,2002-11-21 11:20:00,2002-11-21 13:30:00,4655,4600,55
200211-012,2002-11-22,1,2002-11-22 09:20:00,2002-11-22 13:30:00,4743,4724,-19
200211-013,2002-11-26,-1,2002-11-26 13:05:00,2002-11-26 13:30:00,4678,4684,-6
200211-014,2002-11-27,-1,2002-11-27 10:45:00,2002-11-27 13:20:00,4631,4649,-18
200212-001,2002-12-02,-1,2002-12-02 09:55:00,2002-12-02 12:50:00,4628,4647,-19
200212-002,2002-12-03,1,2002-12-03 09:20:00,2002-12-03 13:30:00,4725,4795,70
200212-003,2002-12-04,-1,2002-12-04 10:20:00,2002-12-04 12:35:00,4735,4758,-23
200212-004,2002-12-10,-1,2002-12-10 09:30:00,2002-12-10 12:40:00,4721,4737,-16
200212-005,2002-12-11,-1,2002-12-11 12:05:00,2002-12-11 13:30:00,4730,4694,36
200212-006,2002-12-12,-1,2002-12-12 09:15:00,2002-12-12 13:30:00,4676,4677,-1
200212-007,2002-12-13,-1,2002-12-13 13:10:00,2002-12-13 13:30:00,4623,4621,2
200212-008,2002-12-16,-1,2002-12-16 09:20:00,2002-12-16 13:30:00,4572,4589,-17
200212-009,2002-12-17,-1,2002-12-17 11:25:00,2002-12-17 13:30:00,4579,4577,2
200212-010,2002-12-18,-1,2002-12-18 11:45:00,2002-12-18 13:30:00,4547,4553,-6
200212-011,2002-12-20,1,2002-12-20 13:00:00,2002-12-20 13:30:00,4575,4578,3
200212-012,2002-12-24,-1,2002-12-24 11:40:00,2002-12-24 13:30:00,4522,4525,-3
200212-013,2002-12-25,-1,2002-12-25 09:15:00,2002-12-25 13:30:00,4510,4492,18
200212-014,2002-12-30,-1,2002-12-30 09:20:00,2002-12-30 13:30:00,4438,4413,25
200212-015,2002-12-31,-1,2002-12-31 10:10:00,2002-12-31 13:00:00,4406,4428,-22
200301-001,2003-01-02,1,2003-01-02 09:25:00,2003-01-02 13:30:00,4438,4463,25
200301-002,2003-01-03,1,2003-01-03 13:20:00,2003-01-03 13:30:00,4594,4584,-10
200301-003,2003-01-06,1,2003-01-06 10:15:00,2003-01-06 13:30:00,4594,4640,46
200301-004,2003-01-07,1,2003-01-07 09:15:00,2003-01-07 13:10:00,4693,4646,-47
200301-005,2003-01-08,1,2003-01-08 10:10:00,2003-01-08 13:30:00,4700,4795,95
200301-006,2003-01-13,1,2003-01-13 09:25:00,2003-01-13 13:30:00,4950,4999,49
200301-007,2003-01-14,1,2003-01-14 11:05:00,2003-01-14 13:30:00,5025,5010,-15
200301-008,2003-01-17,-1,2003-01-17 09:15:00,2003-01-17 13:30:00,4921,4913,8
200301-009,2003-01-21,1,2003-01-21 11:10:00,2003-01-21 13:30:00,4976,4950,-26
200301-010,2003-01-23,1,2003-01-23 09:10:00,2003-01-23 13:30:00,5029,5075,46
200301-011,2003-01-27,-1,2003-01-27 09:30:00,2003-01-27 13:30:00,5003,4960,43
200301-012,2003-01-28,1,2003-01-28 13:10:00,2003-01-28 13:30:00,4995,5006,11
200302-001,2003-02-06,-1,2003-02-06 09:10:00,2003-02-06 13:30:00,4948,4788,160
200302-002,2003-02-07,-1,2003-02-07 10:15:00,2003-02-07 13:30:00,4748,4729,19
200302-003,2003-02-11,-1,2003-02-11 13:15:00,2003-02-11 13:30:00,4630,4635,-5
200302-004,2003-02-13,-1,2003-02-13 09:55:00,2003-02-13 13:30:00,4555,4497,58
200302-005,2003-02-14,-1,2003-02-14 10:55:00,2003-02-14 13:00:00,4481,4520,-39
200302-006,2003-02-17,1,2003-02-17 09:40:00,2003-02-17 13:30:00,4625,4692,67
200302-007,2003-02-18,-1,2003-02-18 09:50:00,2003-02-18 13:30:00,4634,4629,5
200302-008,2003-02-19,-1,2003-02-19 10:35:00,2003-02-19 13:30:00,4580,4547,33
200302-009,2003-02-20,-1,2003-02-20 11:35:00,2003-02-20 13:30:00,4516,4548,-32
200302-010,2003-02-24,1,2003-02-24 13:05:00,2003-02-24 13:30:00,4580,4609,29
200302-011,2003-02-25,-1,2003-02-25 09:10:00,2003-02-25 13:30:00,4521,4442,79
200302-012,2003-02-27,-1,2003-02-27 09:10:00,2003-02-27 10:25:00,4365,4409,-44
200303-001,2003-03-03,1,2003-03-03 10:45:00,2003-03-03 13:30:00,4485,4513,28
200303-002,2003-03-10,-1,2003-03-10 10:50:00,2003-03-10 13:30:00,4340,4327,13
200303-003,2003-03-11,-1,2003-03-11 12:45:00,2003-03-11 13:30:00,4257,4248,9
200303-004,2003-03-13,1,2003-03-13 10:50:00,2003-03-13 13:30:00,4314,4354,40
200303-005,2003-03-17,-1,2003-03-17 09:30:00,2003-03-17 13:30:00,4407,4322,85
200303-006,2003-03-18,1,2003-03-18 09:15:00,2003-03-18 13:30:00,4505,4540,35
200303-007,2003-03-19,-1,2003-03-19 09:10:00,2003-03-19 13:30:00,4506,4511,-5
200303-008,2003-03-20,-1,2003-03-20 11:10:00,2003-03-20 11:20:00,4491,4536,-45
200303-009,2003-03-24,-1,2003-03-24 11:50:00,2003-03-24 13:30:00,4550,4550,0
200303-010,2003-03-26,-1,2003-03-26 12:40:00,2003-03-26 13:30:00,4471,4468,3
200303-011,2003-03-27,1,2003-03-27 13:15:00,2003-03-27 13:30:00,4492,4491,-1
200303-012,2003-03-28,-1,2003-03-28 10:05:00,2003-03-28 13:10:00,4461,4463,-2
200303-013,2003-03-31,-1,2003-03-31 09:10:00,2003-03-31 13:30:00,4386,4273,113
200304-001,2003-04-02,-1,2003-04-02 09:45:00,2003-04-02 12:00:00,4271,4289,-18
200304-002,2003-04-02,1,2003-04-02 12:10:00,2003-04-02 13:30:00,4309,4301,-8
200304-003,2003-04-04,1,2003-04-04 11:20:00,2003-04-04 13:30:00,4378,4474,96
200304-004,2003-04-07,1,2003-04-07 09:35:00,2003-04-07 13:30:00,4509,4561,52
200304-005,2003-04-08,1,2003-04-08 10:55:00,2003-04-08 12:45:00,4582,4536,-46
200304-006,2003-04-09,-1,2003-04-09 09:20:00,2003-04-09 13:30:00,4505,4508,-3
200304-007,2003-04-10,-1,2003-04-10 12:55:00,2003-04-10 13:30:00,4502,4509,-7
200304-008,2003-04-14,-1,2003-04-14 10:55:00,2003-04-14 13:30:00,4438,4448,-10
200304-009,2003-04-16,1,2003-04-16 09:10:00,2003-04-16 13:30:00,4553,4617,64
200304-010,2003-04-17,-1,2003-04-17 09:20:00,2003-04-17 13:05:00,4550,4563,-13
200304-011,2003-04-18,1,2003-04-18 09:10:00,2003-04-18 13:30:00,4647,4659,12
200304-012,2003-04-21,-1,2003-04-21 09:10:00,2003-04-21 13:15:00,4632,4642,-10
200304-013,2003-04-22,-1,2003-04-22 09:20:00,2003-04-22 13:30:00,4597,4571,26
200304-014,2003-04-23,-1,2003-04-23 10:50:00,2003-04-23 13:30:00,4559,4577,-18
200304-015,2003-04-24,-1,2003-04-24 09:10:00,2003-04-24 13:30:00,4521,4355,166
200304-016,2003-04-25,-1,2003-04-25 12:10:00,2003-04-25 13:30:00,4262,4235,27
200304-017,2003-04-28,-1,2003-04-28 09:10:00,2003-04-28 13:10:00,4140,4150,-10
200304-018,2003-04-29,-1,2003-04-29 12:30:00,2003-04-29 13:30:00,4125,4149,-24
200304-019,2003-04-30,-1,2003-04-30 12:30:00,2003-04-30 13:30:00,4130,4118,12
200305-001,2003-05-02,1,2003-05-02 13:10:00,2003-05-02 13:30:00,4199,4194,-5
200305-002,2003-05-06,1,2003-05-06 09:30:00,2003-05-06 13:30:00,4215,4199,-16
200305-003,2003-05-07,1,2003-05-07 12:45:00,2003-05-07 13:30:00,4240,4238,-2
200305-004,2003-05-08,-1,2003-05-08 09:20:00,2003-05-08 13:30:00,4200,4166,34
200305-005,2003-05-09,1,2003-05-09 11:35:00,2003-05-09 13:30:00,4230,4223,-7
200305-006,2003-05-12,1,2003-05-12 09:25:00,2003-05-12 13:30:00,4259,4239,-20
200305-007,2003-05-13,1,2003-05-13 09:10:00,2003-05-13 13:30:00,4328,4314,-14
200305-008,2003-05-15,-1,2003-05-15 09:15:00,2003-05-15 12:25:00,4298,4298,0
200305-009,2003-05-16,-1,2003-05-16 13:10:00,2003-05-16 13:30:00,4282,4276,6
200305-010,2003-05-19,-1,2003-05-19 09:10:00,2003-05-19 12:40:00,4234,4236,-2
200305-011,2003-05-21,-1,2003-05-21 12:40:00,2003-05-21 13:30:00,4213,4228,-15
200305-012,2003-05-22,-1,2003-05-22 09:10:00,2003-05-22 09:45:00,4170,4212,-42
200305-013,2003-05-23,1,2003-05-23 09:20:00,2003-05-23 13:30:00,4278,4333,55
200305-014,2003-05-26,1,2003-05-26 11:15:00,2003-05-26 13:30:00,4419,4446,27
200305-015,2003-05-27,1,2003-05-27 09:15:00,2003-05-27 12:25:00,4460,4415,-45
200305-016,2003-05-29,-1,2003-05-29 09:15:00,2003-05-29 13:10:00,4465,4485,-20
200305-017,2003-05-30,1,2003-05-30 10:45:00,2003-05-30 13:30:00,4535,4532,-3
200306-001,2003-06-02,1,2003-06-02 10:15:00,2003-06-02 13:30:00,4602,4657,55
200306-002,2003-06-09,1,2003-06-09 10:15:00,2003-06-09 13:30:00,4736,4800,64
200306-003,2003-06-10,1,2003-06-10 12:00:00,2003-06-10 13:30:00,4814,4819,5
200306-004,2003-06-11,1,2003-06-11 09:10:00,2003-06-11 10:05:00,4844,4795,-49
200306-005,2003-06-12,1,2003-06-12 10:10:00,2003-06-12 13:30:00,4845,4884,39
200306-006,2003-06-16,1,2003-06-16 11:00:00,2003-06-16 13:30:00,4905,4903,-2
200306-007,2003-06-18,1,2003-06-18 10:10:00,2003-06-18 13:30:00,5050,5020,-30
200306-008,2003-06-19,-1,2003-06-19 10:10:00,2003-06-19 11:00:00,4970,5020,-50
200306-009,2003-06-20,-1,2003-06-20 13:00:00,2003-06-20 13:30:00,5003,5010,-7
200306-010,2003-06-23,-1,2003-06-23 09:15:00,2003-06-23 13:30:00,4991,4938,53
200306-011,2003-06-24,-1,2003-06-24 10:55:00,2003-06-24 13:20:00,4871,4903,-32
200306-012,2003-06-25,1,2003-06-25 13:10:00,2003-06-25 13:30:00,4947,4930,-17
200306-013,2003-06-27,-1,2003-06-27 12:30:00,2003-06-27 13:30:00,4876,4850,26
200307-001,2003-07-01,1,2003-07-01 09:55:00,2003-07-01 13:30:00,4941,5034,93
200307-002,2003-07-02,1,2003-07-02 09:10:00,2003-07-02 13:30:00,5088,5132,44
200307-003,2003-07-04,-1,2003-07-04 09:10:00,2003-07-04 12:00:00,5113,5148,-35
200307-004,2003-07-07,1,2003-07-07 09:25:00,2003-07-07 13:30:00,5248,5353,105
200307-005,2003-07-08,1,2003-07-08 09:30:00,2003-07-08 10:25:00,5415,5360,-55
200307-006,2003-07-10,-1,2003-07-10 11:25:00,2003-07-10 13:30:00,5301,5265,36
200307-007,2003-07-11,-1,2003-07-11 09:25:00,2003-07-11 13:00:00,5186,5215,-29
200307-008,2003-07-14,1,2003-07-14 10:10:00,2003-07-14 13:30:00,5320,5390,70
200307-009,2003-07-15,-1,2003-07-15 13:05:00,2003-07-15 13:30:00,5376,5327,49
200307-010,2003-07-16,1,2003-07-16 11:20:00,2003-07-16 13:30:00,5435,5423,-12
200307-011,2003-07-17,-1,2003-07-17 12:45:00,2003-07-17 13:30:00,5300,5259,41
200307-012,2003-07-18,-1,2003-07-18 09:20:00,2003-07-18 11:40:00,5236,5285,-49
200307-013,2003-07-21,-1,2003-07-21 10:40:00,2003-07-21 13:30:00,5227,5213,14
200307-014,2003-07-22,1,2003-07-22 13:10:00,2003-07-22 13:30:00,5276,5295,19
200307-015,2003-07-23,1,2003-07-23 10:00:00,2003-07-23 13:30:00,5330,5311,-19
200307-016,2003-07-24,1,2003-07-24 09:15:00,2003-07-24 13:30:00,5344,5407,63
200307-017,2003-07-28,1,2003-07-28 09:15:00,2003-07-28 13:30:00,5489,5473,-16
200307-018,2003-07-29,-1,2003-07-29 09:10:00,2003-07-29 13:30:00,5442,5350,92
200308-001,2003-08-01,1,2003-08-01 09:45:00,2003-08-01 13:30:00,5392,5400,8
200308-002,2003-08-04,-1,2003-08-04 10:35:00,2003-08-04 12:50:00,5340,5372,-32
200308-003,2003-08-05,-1,2003-08-05 09:35:00,2003-08-05 13:30:00,5337,5274,63
200308-004,2003-08-07,1,2003-08-07 11:35:00,2003-08-07 13:30:00,5269,5286,17
200308-005,2003-08-08,-1,2003-08-08 11:50:00,2003-08-08 13:30:00,5242,5219,23
200308-006,2003-08-11,-1,2003-08-11 09:10:00,2003-08-11 13:00:00,5190,5216,-26
200308-007,2003-08-12,1,2003-08-12 09:50:00,2003-08-12 13:30:00,5274,5262,-12
200308-008,2003-08-13,1,2003-08-13 09:15:00,2003-08-13 13:30:00,5338,5480,142
200308-009,2003-08-15,1,2003-08-15 09:10:00,2003-08-15 13:30:00,5530,5508,-22
200308-010,2003-08-18,-1,2003-08-18 10:15:00,2003-08-18 12:40:00,5481,5521,-40
200308-011,2003-08-19,-1,2003-08-19 13:05:00,2003-08-19 13:30:00,5526,5554,-28
200308-012,2003-08-21,-1,2003-08-21 09:10:00,2003-08-21 11:00:00,5507,5554,-47
200308-013,2003-08-21,1,2003-08-21 11:20:00,2003-08-21 13:30:00,5567,5633,66
200308-014,2003-08-22,1,2003-08-22 09:20:00,2003-08-22 13:30:00,5642,5627,-15
200308-015,2003-08-26,-1,2003-08-26 09:10:00,2003-08-26 13:30:00,5594,5559,35
200308-016,2003-08-28,-1,2003-08-28 11:35:00,2003-08-28 13:30:00,5525,5531,-6
200308-017,2003-08-29,1,2003-08-29 10:25:00,2003-08-29 13:30:00,5610,5676,66
200309-001,2003-09-03,-1,2003-09-03 13:05:00,2003-09-03 13:30:00,5732,5694,38
200309-002,2003-09-04,-1,2003-09-04 09:25:00,2003-09-04 13:30:00,5672,5639,33
200309-003,2003-09-08,1,2003-09-08 10:30:00,2003-09-08 13:30:00,5715,5759,44
200309-004,2003-09-09,-1,2003-09-09 13:00:00,2003-09-09 13:30:00,5752,5694,58
200309-005,2003-09-10,-1,2003-09-10 09:30:00,2003-09-10 12:55:00,5661,5654,7
200309-006,2003-09-12,1,2003-09-12 13:05:00,2003-09-12 13:30:00,5672,5685,13
200309-007,2003-09-16,1,2003-09-16 09:35:00,2003-09-16 13:30:00,5699,5720,21
200309-008,2003-09-18,-1,2003-09-18 09:20:00,2003-09-18 13:20:00,5732,5739,-7
200309-009,2003-09-30,-1,2003-09-30 09:35:00,2003-09-30 13:30:00,5660,5664,-4
200310-001,2003-10-01,-1,2003-10-01 09:30:00,2003-10-01 13:30:00,5621,5616,5
200310-002,2003-10-02,1,2003-10-02 09:15:00,2003-10-02 13:30:00,5683,5724,41
200310-003,2003-10-03,1,2003-10-03 09:20:00,2003-10-03 13:30:00,5729,5742,13
200310-004,2003-10-06,1,2003-10-06 10:50:00,2003-10-06 13:30:00,5798,5835,37
200310-005,2003-10-08,1,2003-10-08 11:40:00,2003-10-08 13:30:00,5855,5830,-25
200310-006,2003-10-09,1,2003-10-09 11:30:00,2003-10-09 13:30:00,5865,5883,18
200310-007,2003-10-13,1,2003-10-13 10:30:00,2003-10-13 13:30:00,5940,5997,57
200310-008,2003-10-14,-1,2003-10-14 13:05:00,2003-10-14 13:30:00,5996,5970,26
200310-009,2003-10-15,-1,2003-10-15 09:45:00,2003-10-15 13:30:00,5960,5955,5
200310-010,2003-10-16,1,2003-10-16 09:40:00,2003-10-16 13:30:00,6021,6071,50
200310-011,2003-10-20,-1,2003-10-20 09:15:00,2003-10-20 11:00:00,6051,6080,-29
200310-012,2003-10-20,1,2003-10-20 11:20:00,2003-10-20 13:30:00,6085,6106,21
200310-013,2003-10-21,-1,2003-10-21 09:50:00,2003-10-21 13:10:00,6071,6050,21
200310-014,2003-10-23,-1,2003-10-23 09:10:00,2003-10-23 13:30:00,5980,5952,28
200310-015,2003-10-24,-1,2003-10-24 11:50:00,2003-10-24 12:50:00,5945,5967,-22
200310-016,2003-10-28,1,2003-10-28 09:20:00,2003-10-28 13:30:00,6008,6116,108
200310-017,2003-10-30,-1,2003-10-30 09:50:00,2003-10-30 13:30:00,6134,6144,-10
200310-018,2003-10-31,-1,2003-10-31 09:25:00,2003-10-31 13:30:00,6105,6062,43
200311-001,2003-11-05,-1,2003-11-05 10:00:00,2003-11-05 12:05:00,6124,6155,-31
200311-002,2003-11-05,1,2003-11-05 12:40:00,2003-11-05 13:30:00,6175,6168,-7
200311-003,2003-11-06,-1,2003-11-06 12:35:00,2003-11-06 13:30:00,6132,6012,120
200311-004,2003-11-11,-1,2003-11-11 10:15:00,2003-11-11 13:10:00,6005,6030,-25
200311-005,2003-11-14,-1,2003-11-14 09:35:00,2003-11-14 12:20:00,6047,6063,-16
200311-006,2003-11-17,-1,2003-11-17 09:10:00,2003-11-17 13:30:00,5995,5973,22
200311-007,2003-11-18,-1,2003-11-18 10:55:00,2003-11-18 13:15:00,5956,5979,-23
200311-008,2003-11-19,-1,2003-11-19 09:45:00,2003-11-19 13:30:00,5891,5878,13
200311-009,2003-11-21,-1,2003-11-21 09:30:00,2003-11-21 12:35:00,5844,5848,-4
200311-010,2003-11-25,1,2003-11-25 09:50:00,2003-11-25 13:30:00,5925,5888,-37
200311-011,2003-11-27,-1,2003-11-27 10:55:00,2003-11-27 13:30:00,5831,5837,-6
200311-012,2003-11-28,-1,2003-11-28 13:20:00,2003-11-28 13:30:00,5816,5808,8
200312-001,2003-12-01,1,2003-12-01 10:15:00,2003-12-01 13:30:00,5858,5910,52
200312-002,2003-12-04,-1,2003-12-04 09:50:00,2003-12-04 10:55:00,5890,5912,-22
200312-003,2003-12-05,-1,2003-12-05 13:05:00,2003-12-05 13:30:00,5896,5913,-17
200312-004,2003-12-08,-1,2003-12-08 09:15:00,2003-12-08 12:20:00,5845,5853,-8
200312-005,2003-12-11,1,2003-12-11 12:50:00,2003-12-11 13:30:00,5868,5880,12
200312-006,2003-12-12,-1,2003-12-12 12:55:00,2003-12-12 13:30:00,5902,5895,7
200312-007,2003-12-15,1,2003-12-15 13:20:00,2003-12-15 13:30:00,5940,5956,16
200312-008,2003-12-17,-1,2003-12-17 09:30:00,2003-12-17 13:30:00,5893,5765,128
200312-009,2003-12-19,-1,2003-12-19 11:35:00,2003-12-19 13:30:00,5780,5776,4
200312-010,2003-12-22,1,2003-12-22 09:30:00,2003-12-22 13:30:00,5827,5837,10
200312-011,2003-12-25,-1,2003-12-25 13:00:00,2003-12-25 13:30:00,5854,5855,-1
200312-012,2003-12-29,-1,2003-12-29 10:00:00,2003-12-29 13:30:00,5841,5830,11
200312-013,2003-12-30,1,2003-12-30 10:45:00,2003-12-30 13:30:00,5888,5906,18
200401-001,2004-01-02,1,2004-01-02 09:30:00,2004-01-02 13:30:00,5948,6070,122
200401-002,2004-01-05,1,2004-01-05 09:10:00,2004-01-05 13:30:00,6098,6136,38
200401-003,2004-01-07,1,2004-01-07 09:30:00,2004-01-07 13:30:00,6189,6172,-17
200401-004,2004-01-12,-1,2004-01-12 09:20:00,2004-01-12 11:20:00,6242,6270,-28
200401-005,2004-01-13,-1,2004-01-13 12:30:00,2004-01-13 13:30:00,6230,6248,-18
200401-006,2004-01-14,1,2004-01-14 10:10:00,2004-01-14 13:30:00,6289,6328,39
200401-007,2004-01-15,-1,2004-01-15 09:50:00,2004-01-15 11:25:00,6297,6330,-33
200401-008,2004-01-27,1,2004-01-27 10:45:00,2004-01-27 13:30:00,6361,6378,17
200401-009,2004-01-28,1,2004-01-28 11:30:00,2004-01-28 13:30:00,6387,6376,-11
200402-001,2004-02-03,-1,2004-02-03 09:10:00,2004-02-03 13:05:00,6262,6254,8
200402-002,2004-02-05,1,2004-02-05 10:10:00,2004-02-05 13:30:00,6280,6282,2
200402-003,2004-02-06,1,2004-02-06 09:10:00,2004-02-06 13:30:00,6315,6382,67
200402-004,2004-02-09,1,2004-02-09 09:40:00,2004-02-09 13:30:00,6441,6453,12
200402-005,2004-02-10,1,2004-02-10 11:50:00,2004-02-10 13:30:00,6473,6471,-2
200402-006,2004-02-12,1,2004-02-12 09:40:00,2004-02-12 12:55:00,6496,6440,-56
200402-007,2004-02-12,-1,2004-02-12 13:05:00,2004-02-12 13:30:00,6405,6432,-27
200402-008,2004-02-17,1,2004-02-17 09:35:00,2004-02-17 13:30:00,6590,6603,13
200402-009,2004-02-18,1,2004-02-18 09:45:00,2004-02-18 13:30:00,6650,6612,-38
200402-010,2004-02-19,1,2004-02-19 09:10:00,2004-02-19 13:30:00,6657,6718,61
200402-011,2004-02-24,-1,2004-02-24 11:05:00,2004-02-24 13:30:00,6649,6644,5
200402-012,2004-02-25,1,2004-02-25 10:45:00,2004-02-25 13:30:00,6704,6689,-15
200402-013,2004-02-26,1,2004-02-26 10:15:00,2004-02-26 13:30:00,6740,6719,-21
200402-014,2004-02-27,1,2004-02-27 09:30:00,2004-02-27 13:30:00,6751,6794,43
200403-001,2004-03-01,1,2004-03-01 09:55:00,2004-03-01 13:30:00,6918,6972,54
200403-002,2004-03-02,1,2004-03-02 11:20:00,2004-03-02 13:30:00,7025,7057,32
200403-003,2004-03-04,1,2004-03-04 09:25:00,2004-03-04 13:30:00,7073,7144,71
200403-004,2004-03-05,-1,2004-03-05 12:30:00,2004-03-05 13:30:00,7128,7066,62
200403-005,2004-03-08,-1,2004-03-08 12:45:00,2004-03-08 13:30:00,7035,6974,61
200403-006,2004-03-09,-1,2004-03-09 09:25:00,2004-03-09 11:25:00,6940,6996,-56
200403-007,2004-03-10,-1,2004-03-10 10:55:00,2004-03-10 13:30:00,6953,6932,21
200403-008,2004-03-11,-1,2004-03-11 10:05:00,2004-03-11 11:55:00,6854,6918,-64
200403-009,2004-03-15,-1,2004-03-15 12:30:00,2004-03-15 13:30:00,6804,6580,224
200403-010,2004-03-18,1,2004-03-18 09:10:00,2004-03-18 13:30:00,6685,6834,149
200403-011,2004-03-19,1,2004-03-19 09:20:00,2004-03-19 13:30:00,6852,6825,-27
200403-012,2004-03-25,-1,2004-03-25 13:15:00,2004-03-25 13:30:00,6123,6113,10
200403-013,2004-03-26,-1,2004-03-26 10:45:00,2004-03-26 13:30:00,6110,6111,-1
200403-014,2004-03-29,1,2004-03-29 10:10:00,2004-03-29 13:30:00,6415,6460,45
200403-015,2004-03-30,1,2004-03-30 09:55:00,2004-03-30 13:30:00,6488,6476,-12
200403-016,2004-03-31,-1,2004-03-31 12:25:00,2004-03-31 13:30:00,6446,6463,-17
200404-001,2004-04-01,-1,2004-04-01 09:45:00,2004-04-01 12:40:00,6422,6464,-42
200404-002,2004-04-05,1,2004-04-05 10:50:00,2004-04-05 13:30:00,6585,6696,111
200404-003,2004-04-06,1,2004-04-06 09:25:00,2004-04-06 12:40:00,6730,6662,-68
200404-004,2004-04-06,-1,2004-04-06 13:00:00,2004-04-06 13:30:00,6657,6662,-5
200404-005,2004-04-07,-1,2004-04-07 09:15:00,2004-04-07 13:05:00,6643,6664,-21
200404-006,2004-04-08,1,2004-04-08 13:10:00,2004-04-08 13:30:00,6684,6683,-1
200404-007,2004-04-09,-1,2004-04-09 10:05:00,2004-04-09 13:30:00,6601,6610,-9
200404-008,2004-04-12,1,2004-04-12 09:10:00,2004-04-12 13:30:00,6748,6812,64
200404-009,2004-04-13,-1,2004-04-13 11:55:00,2004-04-13 13:30:00,6791,6812,-21
200404-010,2004-04-14,1,2004-04-14 10:35:00,2004-04-14 13:30:00,6833,6920,87
200404-011,2004-04-15,-1,2004-04-15 12:35:00,2004-04-15 13:30:00,6824,6740,84
200404-012,2004-04-19,-1,2004-04-19 10:30:00,2004-04-19 13:30:00,6788,6784,4
200404-013,2004-04-22,1,2004-04-22 09:25:00,2004-04-22 12:40:00,6888,6819,-69
200404-014,2004-04-22,-1,2004-04-22 12:45:00,2004-04-22 13:30:00,6801,6713,88
200404-015,2004-04-27,-1,2004-04-27 09:10:00,2004-04-27 13:25:00,6700,6670,30
200404-016,2004-04-28,-1,2004-04-28 12:10:00,2004-04-28 13:30:00,6617,6619,-2
200404-017,2004-04-29,-1,2004-04-29 09:25:00,2004-04-29 13:30:00,6525,6398,127
200404-018,2004-04-30,-1,2004-04-30 09:15:00,2004-04-30 13:30:00,6306,6114,192
200405-001,2004-05-04,1,2004-05-04 12:05:00,2004-05-04 13:30:00,6120,6156,36
200405-002,2004-05-05,-1,2004-05-05 09:35:00,2004-05-05 13:30:00,6072,5766,306
200405-003,2004-05-07,1,2004-05-07 13:05:00,2004-05-07 13:30:00,5987,5976,-11
200405-004,2004-05-10,-1,2004-05-10 09:10:00,2004-05-10 13:30:00,5803,5757,46
200405-005,2004-05-11,-1,2004-05-11 10:30:00,2004-05-11 10:40:00,5666,5723,-57
200405-006,2004-05-11,1,2004-05-11 13:10:00,2004-05-11 13:30:00,5865,5848,-17
200405-007,2004-05-12,1,2004-05-12 09:50:00,2004-05-12 13:30:00,5959,5952,-7
200405-008,2004-05-14,-1,2004-05-14 09:50:00,2004-05-14 13:30:00,5850,5743,107
200405-009,2004-05-17,-1,2004-05-17 09:10:00,2004-05-17 13:30:00,5531,5370,161
200405-010,2004-05-19,1,2004-05-19 09:10:00,2004-05-19 13:30:00,5680,5898,218
200405-011,2004-05-20,-1,2004-05-20 12:35:00,2004-05-20 13:30:00,5678,5685,-7
200405-012,2004-05-21,1,2004-05-21 11:55:00,2004-05-21 13:30:00,5900,5880,-20
200405-013,2004-05-24,1,2004-05-24 10:40:00,2004-05-24 13:15:00,5915,5855,-60
200405-014,2004-05-26,1,2004-05-26 09:10:00,2004-05-26 11:10:00,6050,5989,-61
200405-015,2004-05-27,-1,2004-05-27 09:25:00,2004-05-27 13:15:00,5971,5985,-14
200405-016,2004-05-31,-1,2004-05-31 10:10:00,2004-05-31 13:30:00,5955,5900,55
200406-001,2004-06-01,-1,2004-06-01 09:35:00,2004-06-01 11:55:00,5860,5919,-59
200406-002,2004-06-03,-1,2004-06-03 10:30:00,2004-06-03 13:30:00,5785,5559,226
200406-003,2004-06-07,1,2004-06-07 09:35:00,2004-06-07 13:30:00,5810,5899,89
200406-004,2004-06-08,1,2004-06-08 12:50:00,2004-06-08 13:30:00,5974,5943,-31
200406-005,2004-06-09,1,2004-06-09 10:15:00,2004-06-09 13:10:00,5989,5929,-60
200406-006,2004-06-10,-1,2004-06-10 09:15:00,2004-06-10 13:25:00,5876,5845,31
200406-007,2004-06-11,-1,2004-06-11 10:00:00,2004-06-11 13:30:00,5703,5704,-1
200406-008,2004-06-14,-1,2004-06-14 12:10:00,2004-06-14 13:30:00,5642,5529,113
200406-009,2004-06-15,-1,2004-06-15 09:30:00,2004-06-15 10:10:00,5511,5567,-56
200406-010,2004-06-16,-1,2004-06-16 11:25:00,2004-06-16 13:30:00,5540,5559,-19
200406-011,2004-06-18,-1,2004-06-18 09:15:00,2004-06-18 13:30:00,5512,5457,55
200406-012,2004-06-21,-1,2004-06-21 12:30:00,2004-06-21 13:30:00,5452,5495,-43
200406-013,2004-06-23,1,2004-06-23 09:30:00,2004-06-23 13:30:00,5639,5666,27
200406-014,2004-06-25,1,2004-06-25 11:35:00,2004-06-25 13:30:00,5748,5727,-21
200406-015,2004-06-28,-1,2004-06-28 09:10:00,2004-06-28 12:55:00,5702,5637,65
200406-016,2004-06-29,1,2004-06-29 12:55:00,2004-06-29 13:30:00,5648,5638,-10
200406-017,2004-06-30,1,2004-06-30 09:10:00,2004-06-30 13:30:00,5754,5765,11
200407-001,2004-07-05,-1,2004-07-05 09:15:00,2004-07-05 12:40:00,5582,5585,-3
200407-002,2004-07-06,1,2004-07-06 13:15:00,2004-07-06 13:30:00,5633,5652,19
200407-003,2004-07-07,1,2004-07-07 11:55:00,2004-07-07 13:30:00,5676,5664,-12
200407-004,2004-07-08,1,2004-07-08 09:25:00,2004-07-08 10:55:00,5688,5631,-57
200407-005,2004-07-08,-1,2004-07-08 11:05:00,2004-07-08 13:30:00,5611,5628,-17
200407-006,2004-07-09,-1,2004-07-09 09:55:00,2004-07-09 11:20:00,5596,5652,-56
200407-007,2004-07-09,1,2004-07-09 13:10:00,2004-07-09 13:30:00,5705,5714,9
200407-008,2004-07-13,-1,2004-07-13 09:20:00,2004-07-13 12:45:00,5657,5685,-28
200407-009,2004-07-14,-1,2004-07-14 13:05:00,2004-07-14 13:30:00,5605,5603,2
200407-010,2004-07-15,-1,2004-07-15 09:20:00,2004-07-15 13:30:00,5575,5530,45
200407-011,2004-07-16,-1,2004-07-16 13:15:00,2004-07-16 13:30:00,5504,5513,-9
200407-012,2004-07-19,-1,2004-07-19 09:55:00,2004-07-19 13:00:00,5462,5498,-36
200407-013,2004-07-20,-1,2004-07-20 10:05:00,2004-07-20 13:30:00,5440,5308,132
200407-014,2004-07-22,-1,2004-07-22 09:10:00,2004-07-22 11:05:00,5232,5285,-53
200407-015,2004-07-27,1,2004-07-27 11:25:00,2004-07-27 13:30:00,5310,5358,48
200407-016,2004-07-29,-1,2004-07-29 09:45:00,2004-07-29 13:30:00,5310,5293,17
200407-017,2004-07-30,1,2004-07-30 09:15:00,2004-07-30 13:30:00,5379,5369,-10
200408-001,2004-08-02,-1,2004-08-02 09:10:00,2004-08-02 13:30:00,5288,5274,14
200408-002,2004-08-04,-1,2004-08-04 09:10:00,2004-08-04 13:20:00,5241,5241,0
200408-003,2004-08-05,-1,2004-08-05 10:50:00,2004-08-05 11:40:00,5216,5269,-53
200408-004,2004-08-05,1,2004-08-05 11:45:00,2004-08-05 13:30:00,5294,5390,96
200408-005,2004-08-11,-1,2004-08-11 12:35:00,2004-08-11 13:30:00,5340,5320,20
200408-006,2004-08-13,1,2004-08-13 11:10:00,2004-08-13 13:30:00,5350,5357,7
200408-007,2004-08-16,-1,2004-08-16 09:10:00,2004-08-16 12:30:00,5321,5348,-27
200408-008,2004-08-18,-1,2004-08-18 09:35:00,2004-08-18 10:15:00,5316,5353,-37
200408-009,2004-08-18,1,2004-08-18 10:20:00,2004-08-18 13:30:00,5375,5413,38
200408-010,2004-08-19,1,2004-08-19 09:25:00,2004-08-19 13:30:00,5455,5531,76
200408-011,2004-08-20,1,2004-08-20 09:10:00,2004-08-20 13:30:00,5548,5584,36
200408-012,2004-08-26,1,2004-08-26 11:05:00,2004-08-26 13:30:00,5794,5791,-3
200408-013,2004-08-27,1,2004-08-27 11:55:00,2004-08-27 13:30:00,5813,5788,-25
200408-014,2004-08-30,1,2004-08-30 09:10:00,2004-08-30 13:30:00,5818,5785,-33
200408-015,2004-08-31,1,2004-08-31 09:45:00,2004-08-31 12:30:00,5819,5760,-59
200408-016,2004-08-31,-1,2004-08-31 12:35:00,2004-08-31 13:30:00,5741,5763,-22
200409-001,2004-09-03,-1,2004-09-03 11:00:00,2004-09-03 13:30:00,5785,5768,17
200409-002,2004-09-06,-1,2004-09-06 09:10:00,2004-09-06 11:55:00,5746,5770,-24
200409-003,2004-09-07,1,2004-09-07 09:20:00,2004-09-07 13:30:00,5788,5823,35
200409-004,2004-09-08,1,2004-09-08 09:20:00,2004-09-08 13:30:00,5860,5824,-36
200409-005,2004-09-09,-1,2004-09-09 09:15:00,2004-09-09 09:55:00,5810,5850,-40
200409-006,2004-09-15,-1,2004-09-15 09:10:00,2004-09-15 13:30:00,5910,5878,32
200409-007,2004-09-17,-1,2004-09-17 09:25:00,2004-09-17 13:30:00,5838,5816,22
200409-008,2004-09-21,1,2004-09-21 09:10:00,2004-09-21 13:30:00,5898,5921,23
200409-009,2004-09-24,-1,2004-09-24 09:30:00,2004-09-24 13:30:00,5896,5883,13
200409-010,2004-09-27,-1,2004-09-27 09:20:00,2004-09-27 13:30:00,5863,5866,-3
200409-011,2004-09-30,-1,2004-09-30 12:55:00,2004-09-30 13:30:00,5865,5880,-15
200410-001,2004-10-01,1,2004-10-01 11:35:00,2004-10-01 13:30:00,5918,5950,32
200410-002,2004-10-04,1,2004-10-04 11:50:00,2004-10-04 13:30:00,6083,6100,17
200410-003,2004-10-06,-1,2004-10-06 13:20:00,2004-10-06 13:30:00,6094,6083,11
200410-004,2004-10-11,-1,2004-10-11 09:20:00,2004-10-11 12:50:00,6088,6095,-7
200410-005,2004-10-12,-1,2004-10-12 09:40:00,2004-10-12 13:30:00,6070,6005,65
200410-006,2004-10-14,-1,2004-10-14 09:20:00,2004-10-14 13:30:00,5888,5839,49
200410-007,2004-10-20,-1,2004-10-20 09:50:00,2004-10-20 13:15:00,5778,5793,-15
200410-008,2004-10-21,1,2004-10-21 09:30:00,2004-10-21 13:30:00,5837,5787,-50
200410-009,2004-10-26,-1,2004-10-26 09:15:00,2004-10-26 13:30:00,5692,5651,41
200410-010,2004-10-27,-1,2004-10-27 09:55:00,2004-10-27 12:05:00,5635,5666,-31
200410-011,2004-10-28,1,2004-10-28 13:20:00,2004-10-28 13:30:00,5730,5729,-1
200411-001,2004-11-01,-1,2004-11-01 12:55:00,2004-11-01 13:30:00,5675,5625,50
200411-002,2004-11-02,1,2004-11-02 12:50:00,2004-11-02 13:30:00,5724,5753,29
200411-003,2004-11-03,1,2004-11-03 09:20:00,2004-11-03 13:30:00,5764,5847,83
200411-004,2004-11-04,1,2004-11-04 12:05:00,2004-11-04 13:30:00,5858,5837,-21
200411-005,2004-11-11,-1,2004-11-11 09:50:00,2004-11-11 13:30:00,5910,5887,23
200411-006,2004-11-12,1,2004-11-12 11:55:00,2004-11-12 13:30:00,5947,5936,-11
200411-007,2004-11-16,-1,2004-11-16 09:25:00,2004-11-16 13:30:00,5925,5930,-5
200411-008,2004-11-17,1,2004-11-17 09:30:00,2004-11-17 13:30:00,5980,6026,46
200411-009,2004-11-18,1,2004-11-18 09:10:00,2004-11-18 13:30:00,6089,6079,-10
200411-010,2004-11-19,-1,2004-11-19 12:45:00,2004-11-19 13:30:00,6050,6053,-3
200411-011,2004-11-22,-1,2004-11-22 09:15:00,2004-11-22 13:30:00,5972,5840,132
200411-012,2004-11-23,-1,2004-11-23 09:50:00,2004-11-23 13:30:00,5811,5850,-39
200411-013,2004-11-25,-1,2004-11-25 10:35:00,2004-11-25 13:30:00,5872,5872,0
200411-014,2004-11-26,1,2004-11-26 09:10:00,2004-11-26 12:40:00,5943,5883,-60
200411-015,2004-11-26,-1,2004-11-26 12:45:00,2004-11-26 13:30:00,5863,5770,93
200411-016,2004-11-30,-1,2004-11-30 09:15:00,2004-11-30 11:20:00,5720,5778,-58
200411-017,2004-11-30,1,2004-11-30 11:30:00,2004-11-30 13:30:00,5813,5754,-59
200412-001,2004-12-06,1,2004-12-06 10:30:00,2004-12-06 13:30:00,5905,5885,-20
200412-002,2004-12-09,-1,2004-12-09 13:20:00,2004-12-09 13:30:00,5870,5870,0
200412-003,2004-12-10,-1,2004-12-10 12:00:00,2004-12-10 13:30:00,5870,5868,2
200412-004,2004-12-13,1,2004-12-13 09:10:00,2004-12-13 12:15:00,5911,5851,-60
200412-005,2004-12-13,-1,2004-12-13 12:25:00,2004-12-13 13:30:00,5850,5843,7
200412-006,2004-12-15,1,2004-12-15 09:50:00,2004-12-15 13:30:00,5956,6024,68
200412-007,2004-12-16,1,2004-12-16 09:25:00,2004-12-16 13:30:00,6030,6025,-5
200412-008,2004-12-22,1,2004-12-22 09:30:00,2004-12-22 13:30:00,6047,6025,-22
200412-009,2004-12-23,-1,2004-12-23 09:20:00,2004-12-23 13:30:00,6006,5988,18
200412-010,2004-12-24,1,2004-12-24 13:15:00,2004-12-24 13:30:00,6045,6036,-9
200412-011,2004-12-27,-1,2004-12-27 09:35:00,2004-12-27 12:50:00,6005,6020,-15
200412-012,2004-12-29,1,2004-12-29 09:15:00,2004-12-29 13:30:00,6095,6106,11
200412-013,2004-12-31,1,2004-12-31 12:00:00,2004-12-31 13:30:00,6155,6177,22
200501-001,2005-01-04,-1,2005-01-04 09:15:00,2005-01-04 13:30:00,6131,6084,47
200501-002,2005-01-06,-1,2005-01-06 09:20:00,2005-01-06 12:15:00,6003,6019,-16
200501-003,2005-01-07,-1,2005-01-07 09:50:00,2005-01-07 13:30:00,5991,5958,33
200501-004,2005-01-11,1,2005-01-11 11:15:00,2005-01-11 13:30:00,6003,6008,5
200501-005,2005-01-12,-1,2005-01-12 09:55:00,2005-01-12 13:30:00,5969,5883,86
200501-006,2005-01-13,-1,2005-01-13 12:20:00,2005-01-13 13:30:00,5871,5869,2
200501-007,2005-01-17,1,2005-01-17 10:50:00,2005-01-17 13:30:00,5980,5962,-18
200501-008,2005-01-18,-1,2005-01-18 10:30:00,2005-01-18 13:30:00,5945,5948,-3
200501-009,2005-01-21,-1,2005-01-21 09:55:00,2005-01-21 13:30:00,5852,5865,-13
200501-010,2005-01-24,-1,2005-01-24 09:35:00,2005-01-24 13:30:00,5833,5795,38
200501-011,2005-01-25,-1,2005-01-25 12:10:00,2005-01-25 13:30:00,5761,5812,-51
200501-012,2005-01-28,1,2005-01-28 10:50:00,2005-01-28 13:30:00,5853,5872,19
200501-013,2005-01-31,1,2005-01-31 09:15:00,2005-01-31 13:30:00,5905,5994,89
200502-001,2005-02-02,1,2005-02-02 09:10:00,2005-02-02 13:30:00,6054,6020,-34
200502-002,2005-02-16,-1,2005-02-16 09:20:00,2005-02-16 13:15:00,6096,6139,-43
200502-003,2005-02-22,-1,2005-02-22 09:15:00,2005-02-22 13:30:00,6134,6096,38
200502-004,2005-02-23,1,2005-02-23 13:10:00,2005-02-23 13:30:00,6118,6120,2
200502-005,2005-02-24,1,2005-02-24 09:30:00,2005-02-24 13:30:00,6128,6130,2
200502-006,2005-02-25,1,2005-02-25 09:10:00,2005-02-25 13:30:00,6215,6221,6
200503-001,2005-03-01,1,2005-03-01 12:40:00,2005-03-01 13:30:00,6246,6241,-5
200503-002,2005-03-02,-1,2005-03-02 09:30:00,2005-03-02 13:30:00,6222,6205,17
200503-003,2005-03-03,-1,2005-03-03 09:30:00,2005-03-03 12:35:00,6190,6200,-10
200503-004,2005-03-08,-1,2005-03-08 09:20:00,2005-03-08 10:15:00,6220,6243,-23
200503-005,2005-03-08,-1,2005-03-08 12:20:00,2005-03-08 13:30:00,6213,6152,61
200503-006,2005-03-10,-1,2005-03-10 10:35:00,2005-03-10 12:55:00,6163,6181,-18
200503-007,2005-03-15,-1,2005-03-15 09:20:00,2005-03-15 13:30:00,6142,6066,76
200503-008,2005-03-17,-1,2005-03-17 09:15:00,2005-03-17 13:30:00,5996,6011,-15
200503-009,2005-03-18,-1,2005-03-18 10:55:00,2005-03-18 13:25:00,6008,6030,-22
200503-010,2005-03-22,-1,2005-03-22 09:20:00,2005-03-22 13:00:00,6016,6022,-6
200503-011,2005-03-23,-1,2005-03-23 10:45:00,2005-03-23 12:25:00,5971,5994,-23
200503-012,2005-03-24,1,2005-03-24 09:45:00,2005-03-24 13:30:00,6027,6004,-23
200503-013,2005-03-29,-1,2005-03-29 09:40:00,2005-03-29 13:30:00,5998,5975,23
200504-001,2005-04-01,-1,2005-04-01 11:05:00,2005-04-01 12:55:00,5975,6006,-31
200504-002,2005-04-01,1,2005-04-01 13:10:00,2005-04-01 13:30:00,6018,6041,23
200504-003,2005-04-04,1,2005-04-04 11:40:00,2005-04-04 13:30:00,6045,6024,-21
200504-004,2005-04-07,-1,2005-04-07 11:10:00,2005-04-07 13:30:00,5989,5987,2
200504-005,2005-04-11,-1,2005-04-11 10:20:00,2005-04-11 13:30:00,5970,5981,-11
200504-006,2005-04-12,1,2005-04-12 12:55:00,2005-04-12 13:30:00,6000,5993,-7
200504-007,2005-04-15,-1,2005-04-15 10:10:00,2005-04-15 13:30:00,5915,5884,31
200504-008,2005-04-18,-1,2005-04-18 11:10:00,2005-04-18 13:30:00,5758,5710,48
200504-009,2005-04-19,1,2005-04-19 13:20:00,2005-04-19 13:30:00,5775,5770,-5
200504-010,2005-04-20,-1,2005-04-20 10:00:00,2005-04-20 13:30:00,5738,5702,36
200504-011,2005-04-22,1,2005-04-22 09:40:00,2005-04-22 13:30:00,5757,5727,-30
200504-012,2005-04-25,-1,2005-04-25 09:15:00,2005-04-25 10:05:00,5708,5732,-24
200504-013,2005-04-26,1,2005-04-26 11:35:00,2005-04-26 13:30:00,5749,5767,18
200504-014,2005-04-28,-1,2005-04-28 09:15:00,2005-04-28 11:40:00,5733,5754,-21
200504-015,2005-04-28,1,2005-04-28 11:50:00,2005-04-28 13:30:00,5765,5776,11
200505-001,2005-05-04,-1,2005-05-04 10:10:00,2005-05-04 13:30:00,5797,5804,-7
200505-002,2005-05-05,1,2005-05-05 09:45:00,2005-05-05 13:30:00,5864,5905,41
200505-003,2005-05-06,1,2005-05-06 12:50:00,2005-05-06 13:30:00,5943,5929,-14
200505-004,2005-05-11,-1,2005-05-11 09:20:00,2005-05-11 13:30:00,5885,5906,-21
200505-005,2005-05-12,1,2005-05-12 13:20:00,2005-05-12 13:30:00,5914,5916,2
200505-006,2005-05-13,1,2005-05-13 09:20:00,2005-05-13 13:30:00,5950,5995,45
200505-007,2005-05-16,-1,2005-05-16 10:50:00,2005-05-16 13:30:00,5956,5939,17
200505-008,2005-05-17,-1,2005-05-17 09:25:00,2005-05-17 13:30:00,5924,5878,46
200505-009,2005-05-20,-1,2005-05-20 13:10:00,2005-05-20 13:30:00,5936,5928,8
200505-010,2005-05-23,-1,2005-05-23 09:15:00,2005-05-23 13:30:00,5881,5867,14
200505-011,2005-05-25,-1,2005-05-25 11:40:00,2005-05-25 13:30:00,5872,5853,19
200505-012,2005-05-27,1,2005-05-27 09:40:00,2005-05-27 13:30:00,5946,5956,10
200505-013,2005-05-30,-1,2005-05-30 10:55:00,2005-05-30 12:05:00,5932,5963,-31
200506-001,2005-06-01,-1,2005-06-01 11:20:00,2005-06-01 12:55:00,5908,5931,-23
200506-002,2005-06-02,1,2005-06-02 09:10:00,2005-06-02 13:30:00,5978,5979,1
200506-003,2005-06-03,1,2005-06-03 10:00:00,2005-06-03 13:30:00,6021,6048,27
200506-004,2005-06-06,1,2005-06-06 10:50:00,2005-06-06 13:30:00,6063,6060,-3
200506-005,2005-06-07,-1,2005-06-07 10:40:00,2005-06-07 12:05:00,6044,6067,-23
200506-006,2005-06-08,1,2005-06-08 09:10:00,2005-06-08 13:30:00,6073,6131,58
200506-007,2005-06-13,1,2005-06-13 12:30:00,2005-06-13 13:30:00,6207,6239,32
200506-008,2005-06-14,1,2005-06-14 09:55:00,2005-06-14 13:30:00,6261,6230,-31
200506-009,2005-06-15,1,2005-06-15 13:15:00,2005-06-15 13:30:00,6267,6259,-8
200506-010,2005-06-16,-1,2005-06-16 09:10:00,2005-06-16 13:10:00,6147,6185,-38
200506-011,2005-06-17,-1,2005-06-17 13:20:00,2005-06-17 13:30:00,6182,6191,-9
200506-012,2005-06-21,-1,2005-06-21 10:40:00,2005-06-21 12:10:00,6173,6195,-22
200506-013,2005-06-22,1,2005-06-22 09:25:00,2005-06-22 13:30:00,6242,6326,84
200506-014,2005-06-24,-1,2005-06-24 09:40:00,2005-06-24 12:35:00,6306,6319,-13
200506-015,2005-06-27,-1,2005-06-27 10:10:00,2005-06-27 13:30:00,6232,6252,-20
200506-016,2005-06-28,1,2005-06-28 12:05:00,2005-06-28 13:30:00,6278,6287,9
200506-017,2005-06-29,-1,2005-06-29 10:15:00,2005-06-29 13:30:00,6258,6220,38
200507-001,2005-07-01,-1,2005-07-01 09:20:00,2005-07-01 12:45:00,6182,6196,-14
200507-002,2005-07-01,1,2005-07-01 13:20:00,2005-07-01 13:30:00,6225,6220,-5
200507-003,2005-07-06,-1,2005-07-06 12:55:00,2005-07-06 13:30:00,6160,6167,-7
200507-004,2005-07-07,-1,2005-07-07 09:15:00,2005-07-07 13:30:00,6150,6152,-2
200507-005,2005-07-08,1,2005-07-08 10:20:00,2005-07-08 13:30:00,6197,6175,-22
200507-006,2005-07-11,1,2005-07-11 12:10:00,2005-07-11 13:30:00,6275,6294,19
200507-007,2005-07-12,1,2005-07-12 09:15:00,2005-07-12 13:30:00,6337,6345,8
200507-008,2005-07-13,1,2005-07-13 10:25:00,2005-07-13 13:30:00,6380,6370,-10
200507-009,2005-07-14,1,2005-07-14 11:30:00,2005-07-14 13:30:00,6420,6425,5
200507-010,2005-07-15,1,2005-07-15 09:20:00,2005-07-15 13:30:00,6446,6430,-16
200507-011,2005-07-19,-1,2005-07-19 09:20:00,2005-07-19 12:20:00,6400,6429,-29
200507-012,2005-07-20,1,2005-07-20 11:00:00,2005-07-20 13:00:00,6448,6410,-38
200507-013,2005-07-20,-1,2005-07-20 13:05:00,2005-07-20 13:30:00,6410,6405,5
200507-014,2005-07-21,-1,2005-07-21 11:40:00,2005-07-21 13:30:00,6342,6360,-18
200507-015,2005-07-22,-1,2005-07-22 09:20:00,2005-07-22 13:30:00,6330,6337,-7
200507-016,2005-07-25,1,2005-07-25 10:40:00,2005-07-25 13:30:00,6382,6390,8
200507-017,2005-07-26,-1,2005-07-26 12:35:00,2005-07-26 13:30:00,6372,6332,40
200507-018,2005-07-27,-1,2005-07-27 09:20:00,2005-07-27 13:30:00,6319,6317,2
200507-019,2005-07-28,1,2005-07-28 13:10:00,2005-07-28 13:30:00,6335,6334,-1
200507-020,2005-07-29,1,2005-07-29 09:10:00,2005-07-29 10:15:00,6388,6324,-64
200508-001,2005-08-02,-1,2005-08-02 10:10:00,2005-08-02 13:25:00,6276,6325,-49
200508-002,2005-08-03,1,2005-08-03 09:20:00,2005-08-03 13:30:00,6392,6443,51
200508-003,2005-08-10,1,2005-08-10 09:20:00,2005-08-10 11:10:00,6424,6359,-65
200508-004,2005-08-10,-1,2005-08-10 13:10:00,2005-08-10 13:30:00,6355,6356,-1
200508-005,2005-08-15,-1,2005-08-15 09:15:00,2005-08-15 13:30:00,6327,6236,91
200508-006,2005-08-16,-1,2005-08-16 12:40:00,2005-08-16 13:10:00,6198,6250,-52
200508-007,2005-08-19,-1,2005-08-19 09:10:00,2005-08-19 11:45:00,6163,6177,-14
200508-008,2005-08-22,1,2005-08-22 13:15:00,2005-08-22 13:30:00,6207,6214,7
200508-009,2005-08-23,-1,2005-08-23 10:40:00,2005-08-23 13:30:00,6182,6191,-9
200508-010,2005-08-24,-1,2005-08-24 09:40:00,2005-08-24 11:45:00,6142,6167,-25
200508-011,2005-08-29,-1,2005-08-29 09:40:00,2005-08-29 13:30:00,6105,6046,59
200508-012,2005-08-31,-1,2005-08-31 11:35:00,2005-08-31 13:30:00,6041,6039,2
200509-001,2005-09-02,1,2005-09-02 13:10:00,2005-09-02 13:30:00,6113,6114,1
200509-002,2005-09-09,-1,2005-09-09 10:20:00,2005-09-09 13:30:00,6130,6120,10
200509-003,2005-09-13,1,2005-09-13 10:10:00,2005-09-13 13:30:00,6168,6169,1
200509-004,2005-09-14,-1,2005-09-14 10:00:00,2005-09-14 13:25:00,6145,6154,-9
200509-005,2005-09-15,-1,2005-09-15 09:15:00,2005-09-15 13:30:00,6116,6096,20
200509-006,2005-09-16,-1,2005-09-16 09:35:00,2005-09-16 13:30:00,6063,6027,36
200509-007,2005-09-20,-1,2005-09-20 09:15:00,2005-09-20 10:15:00,5997,6049,-52
200509-008,2005-09-20,1,2005-09-20 10:20:00,2005-09-20 13:30:00,6065,6114,49
200509-009,2005-09-21,-1,2005-09-21 12:55:00,2005-09-21 13:30:00,6080,6067,13
200509-010,2005-09-22,-1,2005-09-22 09:10:00,2005-09-22 13:30:00,6016,5987,29
200509-011,2005-09-23,-1,2005-09-23 10:45:00,2005-09-23 13:30:00,5931,5930,1
200509-012,2005-09-26,-1,2005-09-26 11:20:00,2005-09-26 12:55:00,5893,5945,-52
200509-013,2005-09-27,1,2005-09-27 10:20:00,2005-09-27 13:30:00,5974,5931,-43
200509-014,2005-09-29,1,2005-09-29 10:30:00,2005-09-29 13:30:00,5973,6003,30
200509-015,2005-09-30,1,2005-09-30 09:10:00,2005-09-30 13:30:00,6060,6100,40
200510-001,2005-10-03,1,2005-10-03 10:45:00,2005-10-03 13:30:00,6115,6118,3
200510-002,2005-10-04,1,2005-10-04 11:35:00,2005-10-04 13:30:00,6155,6152,-3
200510-003,2005-10-12,-1,2005-10-12 09:25:00,2005-10-12 13:30:00,6045,6004,41
200510-004,2005-10-13,-1,2005-10-13 10:55:00,2005-10-13 13:10:00,5943,5969,-26
200510-005,2005-10-17,-1,2005-10-17 10:50:00,2005-10-17 13:30:00,5894,5830,64
200510-006,2005-10-19,-1,2005-10-19 10:05:00,2005-10-19 13:30:00,5721,5690,31
200510-007,2005-10-20,-1,2005-10-20 12:50:00,2005-10-20 13:15:00,5678,5735,-57
200510-008,2005-10-24,-1,2005-10-24 13:00:00,2005-10-24 13:30:00,5700,5709,-9
200510-009,2005-10-25,1,2005-10-25 09:10:00,2005-10-25 12:10:00,5801,5742,-59
200510-010,2005-10-26,-1,2005-10-26 09:20:00,2005-10-26 13:30:00,5708,5714,-6
200510-011,2005-10-31,1,2005-10-31 10:45:00,2005-10-31 13:30:00,5710,5777,67
200511-001,2005-11-02,1,2005-11-02 12:00:00,2005-11-02 13:30:00,5832,5851,19
200511-002,2005-11-03,-1,2005-11-03 13:20:00,2005-11-03 13:30:00,5839,5844,-5
200511-003,2005-11-04,1,2005-11-04 09:10:00,2005-11-04 13:30:00,5898,5878,-20
200511-004,2005-11-07,-1,2005-11-07 10:25:00,2005-11-07 13:30:00,5854,5839,15
200511-005,2005-11-09,1,2005-11-09 10:15:00,2005-11-09 13:30:00,5905,5969,64
200511-006,2005-11-10,1,2005-11-10 09:20:00,2005-11-10 13:30:00,6003,5999,-4
200511-007,2005-11-11,1,2005-11-11 09:10:00,2005-11-11 13:30:00,6080,6078,-2
200511-008,2005-11-14,1,2005-11-14 09:55:00,2005-11-14 13:30:00,6103,6094,-9
200511-009,2005-11-15,-1,2005-11-15 09:50:00,2005-11-15 13:30:00,6048,6016,32
200511-010,2005-11-16,-1,2005-11-16 11:20:00,2005-11-16 13:30:00,6005,6029,-24
200511-011,2005-11-17,-1,2005-11-17 11:10:00,2005-11-17 13:05:00,5990,6034,-44
200511-012,2005-11-18,1,2005-11-18 10:25:00,2005-11-18 13:30:00,6113,6101,-12
200511-013,2005-11-21,1,2005-11-21 11:00:00,2005-11-21 12:55:00,6140,6095,-45
200511-014,2005-11-21,-1,2005-11-21 13:00:00,2005-11-21 13:30:00,6094,6110,-16
200511-015,2005-11-22,-1,2005-11-22 09:15:00,2005-11-22 13:30:00,6080,6074,6
200511-016,2005-11-23,1,2005-11-23 13:00:00,2005-11-23 13:30:00,6120,6116,-4
200511-017,2005-11-24,1,2005-11-24 12:00:00,2005-11-24 13:30:00,6127,6098,-29
200511-018,2005-11-28,1,2005-11-28 09:55:00,2005-11-28 13:30:00,6169,6213,44
200511-019,2005-11-29,-1,2005-11-29 10:50:00,2005-11-29 13:30:00,6181,6159,22
200511-020,2005-11-30,1,2005-11-30 12:50:00,2005-11-30 13:30:00,6200,6181,-19
200512-001,2005-12-01,-1,2005-12-01 09:20:00,2005-12-01 13:30:00,6156,6165,-9
200512-002,2005-12-05,1,2005-12-05 12:30:00,2005-12-05 13:30:00,6297,6351,54
200512-003,2005-12-06,1,2005-12-06 10:10:00,2005-12-06 13:30:00,6363,6367,4
200512-004,2005-12-08,-1,2005-12-08 09:30:00,2005-12-08 13:30:00,6311,6228,83
200512-005,2005-12-09,-1,2005-12-09 11:45:00,2005-12-09 13:00:00,6214,6255,-41
200512-006,2005-12-12,-1,2005-12-12 09:25:00,2005-12-12 12:50:00,6200,6250,-50
200512-007,2005-12-13,1,2005-12-13 12:40:00,2005-12-13 13:30:00,6285,6239,-46
200512-008,2005-12-14,-1,2005-12-14 10:05:00,2005-12-14 13:30:00,6226,6219,7
200512-009,2005-12-16,1,2005-12-16 09:10:00,2005-12-16 13:30:00,6320,6350,30
200512-010,2005-12-19,1,2005-12-19 10:10:00,2005-12-19 13:30:00,6385,6444,59
200512-011,2005-12-21,1,2005-12-21 10:30:00,2005-12-21 13:30:00,6463,6472,9
200512-012,2005-12-22,-1,2005-12-22 13:05:00,2005-12-22 13:30:00,6442,6433,9
200512-013,2005-12-23,1,2005-12-23 11:35:00,2005-12-23 13:30:00,6489,6544,55
200512-014,2005-12-27,-1,2005-12-27 10:30:00,2005-12-27 11:55:00,6533,6580,-47
200512-015,2005-12-28,-1,2005-12-28 09:45:00,2005-12-28 13:00:00,6514,6545,-31
200512-016,2005-12-29,1,2005-12-29 09:40:00,2005-12-29 13:30:00,6598,6611,13
200512-017,2005-12-30,-1,2005-12-30 10:25:00,2005-12-30 13:30:00,6583,6587,-4
200601-001,2006-01-03,1,2006-01-03 11:40:00,2006-01-03 13:30:00,6555,6617,62
200601-002,2006-01-04,-1,2006-01-04 13:20:00,2006-01-04 13:30:00,6617,6630,-13
200601-003,2006-01-05,1,2006-01-05 09:10:00,2006-01-05 13:30:00,6703,6720,17
200601-004,2006-01-10,-1,2006-01-10 10:30:00,2006-01-10 13:30:00,6719,6722,-3
200601-005,2006-01-11,1,2006-01-11 12:55:00,2006-01-11 13:30:00,6741,6766,25
200601-006,2006-01-12,-1,2006-01-12 13:10:00,2006-01-12 13:30:00,6751,6718,33
200601-007,2006-01-13,-1,2006-01-13 12:45:00,2006-01-13 13:30:00,6692,6718,-26
200601-008,2006-01-17,-1,2006-01-17 13:15:00,2006-01-17 13:30:00,6719,6705,14
200601-009,2006-01-18,-1,2006-01-18 09:10:00,2006-01-18 13:30:00,6602,6505,97
200601-010,2006-01-19,-1,2006-01-19 11:15:00,2006-01-19 12:15:00,6461,6526,-65
200601-011,2006-01-20,-1,2006-01-20 12:15:00,2006-01-20 13:30:00,6482,6483,-1
200601-012,2006-01-24,1,2006-01-24 13:10:00,2006-01-24 13:30:00,6455,6448,-7
200601-013,2006-01-25,1,2006-01-25 12:05:00,2006-01-25 13:30:00,6514,6505,-9
200602-001,2006-02-03,1,2006-02-03 09:10:00,2006-02-03 13:30:00,6605,6570,-35
200602-002,2006-02-06,1,2006-02-06 12:50:00,2006-02-06 13:30:00,6588,6672,84
200602-003,2006-02-07,1,2006-02-07 09:40:00,2006-02-07 13:30:00,6722,6696,-26
200602-004,2006-02-08,-1,2006-02-08 09:10:00,2006-02-08 13:30:00,6681,6632,49
200602-005,2006-02-09,-1,2006-02-09 13:05:00,2006-02-09 13:30:00,6616,6588,28
200602-006,2006-02-10,-1,2006-02-10 09:20:00,2006-02-10 13:10:00,6572,6598,-26
200602-007,2006-02-13,-1,2006-02-13 12:30:00,2006-02-13 13:30:00,6526,6545,-19
200602-008,2006-02-14,-1,2006-02-14 09:15:00,2006-02-14 09:50:00,6515,6558,-43
200602-009,2006-02-14,1,2006-02-14 12:35:00,2006-02-14 13:30:00,6601,6616,15
200602-010,2006-02-15,1,2006-02-15 09:15:00,2006-02-15 13:30:00,6627,6592,-35
200602-011,2006-02-16,1,2006-02-16 09:20:00,2006-02-16 13:30:00,6643,6675,32
200602-012,2006-02-17,-1,2006-02-17 12:40:00,2006-02-17 13:30:00,6645,6666,-21
200602-013,2006-02-22,-1,2006-02-22 09:20:00,2006-02-22 13:30:00,6604,6512,92
200602-014,2006-02-23,-1,2006-02-23 12:40:00,2006-02-23 13:30:00,6496,6495,1
200602-015,2006-02-27,1,2006-02-27 10:25:00,2006-02-27 13:30:00,6533,6541,8
200603-001,2006-03-01,1,2006-03-01 10:40:00,2006-03-01 13:30:00,6548,6601,53
200603-002,2006-03-02,1,2006-03-02 09:10:00,2006-03-02 13:30:00,6635,6621,-14
200603-003,2006-03-03,-1,2006-03-03 11:10:00,2006-03-03 13:30:00,6576,6513,63
200603-004,2006-03-06,-1,2006-03-06 11:00:00,2006-03-06 12:30:00,6495,6534,-39
200603-005,2006-03-07,-1,2006-03-07 09:15:00,2006-03-07 13:30:00,6485,6462,23
200603-006,2006-03-08,-1,2006-03-08 10:30:00,2006-03-08 13:15:00,6455,6470,-15
200603-007,2006-03-13,1,2006-03-13 13:10:00,2006-03-13 13:30:00,6523,6532,9
200603-008,2006-03-14,-1,2006-03-14 10:20:00,2006-03-14 13:30:00,6495,6445,50
200603-009,2006-03-15,1,2006-03-15 12:55:00,2006-03-15 13:30:00,6515,6519,4
200603-010,2006-03-16,1,2006-03-16 09:40:00,2006-03-16 13:20:00,6540,6474,-66
200603-011,2006-03-17,-1,2006-03-17 09:10:00,2006-03-17 11:45:00,6435,6472,-37
200603-012,2006-03-22,-1,2006-03-22 10:20:00,2006-03-22 13:30:00,6372,6363,9
200603-013,2006-03-28,1,2006-03-28 09:25:00,2006-03-28 13:30:00,6400,6415,15
200603-014,2006-03-29,1,2006-03-29 10:15:00,2006-03-29 13:30:00,6425,6444,19
200603-015,2006-03-30,1,2006-03-30 10:00:00,2006-03-30 13:30:00,6481,6468,-13
200603-016,2006-03-31,1,2006-03-31 09:10:00,2006-03-31 13:30:00,6518,6567,49
200604-001,2006-04-03,1,2006-04-03 10:00:00,2006-04-03 13:30:00,6590,6630,40
200604-002,2006-04-07,1,2006-04-07 11:50:00,2006-04-07 13:30:00,6737,6750,13
200604-003,2006-04-10,1,2006-04-10 10:50:00,2006-04-10 13:30:00,6791,6772,-19
200604-004,2006-04-11,-1,2006-04-11 09:15:00,2006-04-11 12:35:00,6743,6740,3
200604-005,2006-04-12,1,2006-04-12 10:30:00,2006-04-12 13:30:00,6779,6804,25
200604-006,2006-04-13,1,2006-04-13 11:20:00,2006-04-13 13:30:00,6855,6859,4
200604-007,2006-04-14,1,2006-04-14 09:45:00,2006-04-14 13:30:00,6888,6975,87
200604-008,2006-04-17,1,2006-04-17 11:30:00,2006-04-17 13:30:00,7028,7005,-23
200604-009,2006-04-18,-1,2006-04-18 10:15:00,2006-04-18 12:05:00,6935,6989,-54
200604-010,2006-04-20,1,2006-04-20 11:55:00,2006-04-20 13:30:00,7115,7109,-6
200604-011,2006-04-21,1,2006-04-21 09:15:00,2006-04-21 13:30:00,7148,7096,-52
200604-012,2006-04-25,-1,2006-04-25 10:40:00,2006-04-25 13:30:00,7076,7059,17
200604-013,2006-04-26,1,2006-04-26 13:05:00,2006-04-26 13:30:00,7153,7202,49
200604-014,2006-04-28,-1,2006-04-28 09:15:00,2006-04-28 12:45:00,7150,7159,-9
200605-001,2006-05-02,1,2006-05-02 10:55:00,2006-05-02 13:30:00,7220,7184,-36
200605-002,2006-05-03,1,2006-05-03 10:00:00,2006-05-03 13:30:00,7278,7263,-15
200605-003,2006-05-04,1,2006-05-04 10:45:00,2006-05-04 13:30:00,7332,7367,35
200605-004,2006-05-05,1,2006-05-05 10:00:00,2006-05-05 13:30:00,7420,7405,-15
200605-005,2006-05-09,-1,2006-05-09 12:40:00,2006-05-09 13:30:00,7436,7425,11
200605-006,2006-05-10,-1,2006-05-10 10:20:00,2006-05-10 13:30:00,7392,7314,78
200605-007,2006-05-12,-1,2006-05-12 10:00:00,2006-05-12 12:05:00,7266,7312,-46
200605-008,2006-05-15,-1,2006-05-15 09:15:00,2006-05-15 13:30:00,7185,7157,28
200605-009,2006-05-16,-1,2006-05-16 12:35:00,2006-05-16 13:30:00,7093,7036,57
200605-010,2006-05-19,1,2006-05-19 12:00:00,2006-05-19 13:30:00,7054,7050,-4
200605-011,2006-05-22,1,2006-05-22 09:15:00,2006-05-22 11:30:00,7081,7010,-71
200605-012,2006-05-22,-1,2006-05-22 11:45:00,2006-05-22 13:30:00,6994,6904,90
200605-013,2006-05-23,-1,2006-05-23 12:50:00,2006-05-23 13:30:00,6814,6846,-32
200605-014,2006-05-24,-1,2006-05-24 12:00:00,2006-05-24 13:10:00,6801,6870,-69
200605-015,2006-05-24,1,2006-05-24 13:15:00,2006-05-24 13:30:00,6914,6899,-15
200605-016,2006-05-26,1,2006-05-26 09:10:00,2006-05-26 12:00:00,6950,6880,-70
200605-017,2006-05-30,-1,2006-05-30 10:15:00,2006-05-30 11:35:00,6828,6897,-69
200606-001,2006-06-02,1,2006-06-02 12:30:00,2006-06-02 13:30:00,6923,6950,27
200606-002,2006-06-05,-1,2006-06-05 12:20:00,2006-06-05 13:30:00,6862,6671,191
200606-003,2006-06-06,-1,2006-06-06 11:20:00,2006-06-06 12:45:00,6612,6679,-67
200606-004,2006-06-07,-1,2006-06-07 11:25:00,2006-06-07 13:30:00,6605,6593,12
200606-005,2006-06-08,-1,2006-06-08 09:40:00,2006-06-08 13:30:00,6502,6272,230
200606-006,2006-06-14,1,2006-06-14 11:00:00,2006-06-14 13:30:00,6409,6464,55
200606-007,2006-06-15,-1,2006-06-15 11:40:00,2006-06-15 13:30:00,6386,6399,-13
200606-008,2006-06-20,-1,2006-06-20 09:15:00,2006-06-20 13:30:00,6536,6353,183
200606-009,2006-06-22,1,2006-06-22 09:55:00,2006-06-22 13:30:00,6424,6447,23
200606-010,2006-06-23,-1,2006-06-23 09:10:00,2006-06-23 12:55:00,6372,6350,22
200606-011,2006-06-26,1,2006-06-26 12:20:00,2006-06-26 13:30:00,6446,6475,29
200606-012,2006-06-27,1,2006-06-27 09:40:00,2006-06-27 13:30:00,6525,6484,-41
200606-013,2006-06-28,-1,2006-06-28 09:55:00,2006-06-28 12:55:00,6402,6450,-48
200606-014,2006-06-29,1,2006-06-29 09:55:00,2006-06-29 13:30:00,6535,6540,5
200607-001,2006-07-04,1,2006-07-04 10:05:00,2006-07-04 13:10:00,6693,6646,-47
200607-002,2006-07-04,-1,2006-07-04 13:15:00,2006-07-04 13:30:00,6640,6656,-16
200607-003,2006-07-05,-1,2006-07-05 11:45:00,2006-07-05 13:30:00,6626,6585,41
200607-004,2006-07-06,-1,2006-07-06 09:10:00,2006-07-06 12:45:00,6536,6577,-41
200607-005,2006-07-10,1,2006-07-10 12:05:00,2006-07-10 13:30:00,6588,6645,57
200607-006,2006-07-12,1,2006-07-12 10:00:00,2006-07-12 12:05:00,6659,6592,-67
200607-007,2006-07-12,-1,2006-07-12 12:15:00,2006-07-12 13:30:00,6592,6584,8
200607-008,2006-07-13,-1,2006-07-13 12:55:00,2006-07-13 13:30:00,6513,6518,-5
200607-009,2006-07-14,-1,2006-07-14 10:55:00,2006-07-14 13:30:00,6370,6362,8
200607-010,2006-07-17,-1,2006-07-17 12:10:00,2006-07-17 13:30:00,6250,6213,37
200607-011,2006-07-19,1,2006-07-19 09:30:00,2006-07-19 13:30:00,6304,6274,-30
200607-012,2006-07-21,-1,2006-07-21 09:45:00,2006-07-21 12:45:00,6258,6274,-16
200607-013,2006-07-26,-1,2006-07-26 09:10:00,2006-07-26 10:00:00,6278,6333,-55
200607-014,2006-07-27,1,2006-07-27 10:50:00,2006-07-27 13:30:00,6358,6403,45
200607-015,2006-07-28,1,2006-07-28 10:00:00,2006-07-28 11:15:00,6425,6360,-65
200607-016,2006-07-31,-1,2006-07-31 11:20:00,2006-07-31 13:30:00,6377,6364,13
200608-001,2006-08-02,1,2006-08-02 11:00:00,2006-08-02 13:30:00,6434,6425,-9
200608-002,2006-08-03,-1,2006-08-03 10:40:00,2006-08-03 13:30:00,6415,6421,-6
200608-003,2006-08-04,-1,2006-08-04 13:10:00,2006-08-04 13:30:00,6352,6364,-12
200608-004,2006-08-08,1,2006-08-08 09:35:00,2006-08-08 13:30:00,6434,6472,38
200608-005,2006-08-09,1,2006-08-09 12:30:00,2006-08-09 13:30:00,6501,6550,49
200608-006,2006-08-10,1,2006-08-10 09:20:00,2006-08-10 13:30:00,6580,6555,-25
200608-007,2006-08-14,1,2006-08-14 09:20:00,2006-08-14 13:30:00,6628,6600,-28
200608-008,2006-08-16,1,2006-08-16 11:20:00,2006-08-16 13:30:00,6684,6702,18
200608-009,2006-08-17,-1,2006-08-17 13:10:00,2006-08-17 13:30:00,6688,6705,-17
200608-010,2006-08-21,-1,2006-08-21 09:30:00,2006-08-21 13:30:00,6660,6472,188
200608-011,2006-08-23,-1,2006-08-23 09:15:00,2006-08-23 12:30:00,6486,6545,-59
200608-012,2006-08-25,-1,2006-08-25 12:55:00,2006-08-25 13:30:00,6504,6497,7
200608-013,2006-08-28,-1,2006-08-28 09:15:00,2006-08-28 13:30:00,6435,6420,15
200608-014,2006-08-30,1,2006-08-30 09:10:00,2006-08-30 13:30:00,6510,6549,39
200608-015,2006-08-31,1,2006-08-31 12:00:00,2006-08-31 13:30:00,6644,6621,-23
200609-001,2006-09-06,-1,2006-09-06 11:40:00,2006-09-06 13:30:00,6650,6649,1
200609-002,2006-09-07,-1,2006-09-07 10:30:00,2006-09-07 12:05:00,6593,6620,-27
200609-003,2006-09-08,1,2006-09-08 10:20:00,2006-09-08 13:30:00,6680,6679,-1
200609-004,2006-09-11,-1,2006-09-11 12:15:00,2006-09-11 13:30:00,6658,6662,-4
200609-005,2006-09-12,-1,2006-09-12 09:10:00,2006-09-12 13:30:00,6613,6600,13
200609-006,2006-09-14,-1,2006-09-14 10:30:00,2006-09-14 13:30:00,6616,6578,38
200609-007,2006-09-18,1,2006-09-18 09:20:00,2006-09-18 13:30:00,6799,6892,93
200609-008,2006-09-20,-1,2006-09-20 10:45:00,2006-09-20 12:40:00,6838,6873,-35
200609-009,2006-09-21,-1,2006-09-21 10:45:00,2006-09-21 13:30:00,6837,6873,-36
200609-010,2006-09-25,1,2006-09-25 09:10:00,2006-09-25 10:55:00,6883,6830,-53
200609-011,2006-09-28,-1,2006-09-28 10:50:00,2006-09-28 13:30:00,6881,6890,-9
200610-001,2006-10-02,1,2006-10-02 09:10:00,2006-10-02 13:30:00,6908,6950,42
200610-002,2006-10-04,-1,2006-10-04 09:20:00,2006-10-04 13:30:00,6928,6861,67
200610-003,2006-10-05,1,2006-10-05 11:35:00,2006-10-05 13:30:00,6968,7009,41
200610-004,2006-10-12,-1,2006-10-12 09:40:00,2006-10-12 12:55:00,6992,7006,-14
200610-005,2006-10-13,1,2006-10-13 11:40:00,2006-10-13 13:30:00,7068,7080,12
200610-006,2006-10-16,1,2006-10-16 10:05:00,2006-10-16 13:30:00,7149,7124,-25
200610-007,2006-10-17,-1,2006-10-17 09:20:00,2006-10-17 13:30:00,7107,7083,24
200610-008,2006-10-18,-1,2006-10-18 09:15:00,2006-10-18 13:05:00,7038,7015,23
200610-009,2006-10-19,-1,2006-10-19 11:05:00,2006-10-19 13:30:00,6976,6979,-3
200610-010,2006-10-24,1,2006-10-24 10:00:00,2006-10-24 13:30:00,7093,7088,-5
200610-011,2006-10-25,-1,2006-10-25 11:25:00,2006-10-25 13:30:00,7072,7076,-4
200610-012,2006-10-26,1,2006-10-26 09:10:00,2006-10-26 13:30:00,7109,7089,-20
200610-013,2006-10-27,1,2006-10-27 09:15:00,2006-10-27 13:30:00,7125,7090,-35
200610-014,2006-10-30,-1,2006-10-30 09:40:00,2006-10-30 13:00:00,7000,7002,-2
200610-015,2006-10-31,-1,2006-10-31 09:20:00,2006-10-31 11:35:00,6976,6998,-22
200611-001,2006-11-02,1,2006-11-02 09:55:00,2006-11-02 13:30:00,7025,7047,22
200611-002,2006-11-03,1,2006-11-03 09:20:00,2006-11-03 13:30:00,7083,7160,77
200611-003,2006-11-07,1,2006-11-07 10:15:00,2006-11-07 13:30:00,7202,7183,-19
200611-004,2006-11-08,-1,2006-11-08 09:25:00,2006-11-08 13:30:00,7165,7165,0
200611-005,2006-11-09,1,2006-11-09 09:10:00,2006-11-09 13:05:00,7217,7154,-63
200611-006,2006-11-09,-1,2006-11-09 13:10:00,2006-11-09 13:30:00,7143,7126,17
200611-007,2006-11-10,-1,2006-11-10 09:40:00,2006-11-10 13:20:00,7105,7154,-49
200611-008,2006-11-14,1,2006-11-14 10:50:00,2006-11-14 13:30:00,7195,7202,7
200611-009,2006-11-16,1,2006-11-16 09:45:00,2006-11-16 13:30:00,7266,7247,-19
200611-010,2006-11-20,-1,2006-11-20 09:50:00,2006-11-20 13:30:00,7215,7220,-5
200611-011,2006-11-21,1,2006-11-21 11:40:00,2006-11-21 13:30:00,7300,7299,-1
200611-012,2006-11-22,1,2006-11-22 13:15:00,2006-11-22 13:30:00,7335,7341,6
200611-013,2006-11-23,1,2006-11-23 09:10:00,2006-11-23 13:30:00,7355,7381,26
200611-014,2006-11-27,1,2006-11-27 12:20:00,2006-11-27 13:30:00,7499,7496,-3
200611-015,2006-11-29,-1,2006-11-29 10:50:00,2006-11-29 13:30:00,7445,7455,-10
200611-016,2006-11-30,1,2006-11-30 10:40:00,2006-11-30 13:30:00,7515,7533,18
200612-001,2006-12-01,1,2006-12-01 09:25:00,2006-12-01 13:30:00,7562,7593,31
200612-002,2006-12-04,1,2006-12-04 12:05:00,2006-12-04 13:30:00,7668,7662,-6
200612-003,2006-12-05,-1,2006-12-05 11:45:00,2006-12-05 13:30:00,7635,7590,45
200612-004,2006-12-06,1,2006-12-06 13:15:00,2006-12-06 13:30:00,7690,7711,21
200612-005,2006-12-08,-1,2006-12-08 09:10:00,2006-12-08 13:30:00,7654,7609,45
200612-006,2006-12-11,-1,2006-12-11 09:15:00,2006-12-11 13:30:00,7588,7610,-22
200612-007,2006-12-12,-1,2006-12-12 09:25:00,2006-12-12 13:30:00,7562,7480,82
200612-008,2006-12-13,-1,2006-12-13 10:15:00,2006-12-13 13:15:00,7454,7456,-2
200612-009,2006-12-18,1,2006-12-18 10:40:00,2006-12-18 13:30:00,7573,7641,68
200612-010,2006-12-19,1,2006-12-19 10:25:00,2006-12-19 11:15:00,7668,7591,-77
200612-011,2006-12-20,1,2006-12-20 11:55:00,2006-12-20 13:30:00,7675,7655,-20
200612-012,2006-12-21,1,2006-12-21 09:20:00,2006-12-21 12:55:00,7686,7631,-55
200612-013,2006-12-21,-1,2006-12-21 13:10:00,2006-12-21 13:30:00,7620,7639,-19
200612-014,2006-12-22,1,2006-12-22 13:05:00,2006-12-22 13:30:00,7681,7677,-4
200612-015,2006-12-26,1,2006-12-26 09:55:00,2006-12-26 13:30:00,7780,7783,3
200612-016,2006-12-27,1,2006-12-27 09:10:00,2006-12-27 13:30:00,7825,7795,-30
200612-017,2006-12-28,-1,2006-12-28 09:35:00,2006-12-28 12:20:00,7778,7807,-29
200612-018,2006-12-29,1,2006-12-29 12:00:00,2006-12-29 13:30:00,7866,7883,17
200701-001,2007-01-02,1,2007-01-02 09:40:00,2007-01-02 13:30:00,7907,7982,75
200701-002,2007-01-03,1,2007-01-03 09:20:00,2007-01-03 13:30:00,8018,7985,-33
200701-003,2007-01-05,-1,2007-01-05 09:15:00,2007-01-05 13:30:00,7910,7851,59
200701-004,2007-01-08,-1,2007-01-08 09:15:00,2007-01-08 13:30:00,7762,7744,18
200701-005,2007-01-10,-1,2007-01-10 09:35:00,2007-01-10 13:30:00,7675,7692,-17
200701-006,2007-01-11,-1,2007-01-11 10:25:00,2007-01-11 13:30:00,7670,7606,64
200701-007,2007-01-12,1,2007-01-12 10:35:00,2007-01-12 13:30:00,7738,7792,54
200701-008,2007-01-15,-1,2007-01-15 10:25:00,2007-01-15 13:30:00,7747,7794,-47
200701-009,2007-01-17,1,2007-01-17 11:45:00,2007-01-17 13:30:00,7835,7834,-1
200701-010,2007-01-18,1,2007-01-18 13:20:00,2007-01-18 13:30:00,7910,7918,8
200701-011,2007-01-22,-1,2007-01-22 09:15:00,2007-01-22 11:50:00,7852,7885,-33
200701-012,2007-01-24,1,2007-01-24 12:45:00,2007-01-24 13:30:00,7990,7988,-2
200701-013,2007-01-25,-1,2007-01-25 12:45:00,2007-01-25 13:30:00,7975,7970,5
200701-014,2007-01-26,-1,2007-01-26 10:50:00,2007-01-26 13:30:00,7875,7839,36
200701-015,2007-01-29,-1,2007-01-29 13:00:00,2007-01-29 13:30:00,7765,7781,-16
200701-016,2007-01-31,-1,2007-01-31 10:45:00,2007-01-31 13:30:00,7721,7718,3
200702-001,2007-02-02,1,2007-02-02 09:30:00,2007-02-02 13:30:00,7810,7817,7
200702-002,2007-02-06,1,2007-02-06 11:25:00,2007-02-06 13:30:00,7839,7876,37
200702-003,2007-02-08,-1,2007-02-08 10:10:00,2007-02-08 13:30:00,7851,7848,3
200702-004,2007-02-09,1,2007-02-09 10:10:00,2007-02-09 13:30:00,7907,7876,-31
200702-005,2007-02-12,-1,2007-02-12 09:45:00,2007-02-12 13:30:00,7815,7806,9
200702-006,2007-02-13,-1,2007-02-13 11:25:00,2007-02-13 13:30:00,7752,7763,-11
200702-007,2007-02-14,1,2007-02-14 12:20:00,2007-02-14 13:30:00,7825,7831,6
200702-008,2007-02-27,1,2007-02-27 09:40:00,2007-02-27 13:30:00,7945,7933,-12
200703-001,2007-03-01,-1,2007-03-01 09:50:00,2007-03-01 13:30:00,7731,7679,52
200703-002,2007-03-03,-1,2007-03-03 12:00:00,2007-03-03 13:30:00,7578,7591,-13
200703-003,2007-03-05,-1,2007-03-05 09:50:00,2007-03-05 13:30:00,7490,7315,175
200703-004,2007-03-07,1,2007-03-07 11:30:00,2007-03-07 13:30:00,7449,7418,-31
200703-005,2007-03-08,1,2007-03-08 09:20:00,2007-03-08 13:30:00,7469,7527,58
200703-006,2007-03-09,1,2007-03-09 09:25:00,2007-03-09 13:30:00,7557,7520,-37
200703-007,2007-03-12,1,2007-03-12 10:05:00,2007-03-12 13:30:00,7577,7590,13
200703-008,2007-03-13,1,2007-03-13 10:15:00,2007-03-13 13:30:00,7630,7636,6
200703-009,2007-03-14,-1,2007-03-14 09:10:00,2007-03-14 13:30:00,7452,7472,-20
200703-010,2007-03-15,1,2007-03-15 10:20:00,2007-03-15 13:30:00,7654,7657,3
200703-011,2007-03-16,1,2007-03-16 11:50:00,2007-03-16 13:30:00,7677,7683,6
200703-012,2007-03-22,1,2007-03-22 09:15:00,2007-03-22 13:30:00,7836,7840,4
200703-013,2007-03-23,1,2007-03-23 11:20:00,2007-03-23 13:30:00,7885,7843,-42
200703-014,2007-03-27,-1,2007-03-27 12:05:00,2007-03-27 13:30:00,7857,7835,22
200703-015,2007-03-28,-1,2007-03-28 09:15:00,2007-03-28 13:30:00,7794,7756,38
200703-016,2007-03-29,1,2007-03-29 12:00:00,2007-03-29 13:30:00,7826,7839,13
200703-017,2007-03-30,-1,2007-03-30 11:20:00,2007-03-30 13:30:00,7813,7833,-20
200704-001,2007-04-02,1,2007-04-02 09:55:00,2007-04-02 13:30:00,7878,7856,-22
200704-002,2007-04-04,1,2007-04-04 11:50:00,2007-04-04 13:30:00,8000,7997,-3
200704-003,2007-04-09,1,2007-04-09 09:35:00,2007-04-09 13:30:00,8056,8064,8
200704-004,2007-04-10,-1,2007-04-10 11:05:00,2007-04-10 13:05:00,8022,8053,-31
200704-005,2007-04-11,1,2007-04-11 09:25:00,2007-04-11 13:30:00,8088,8093,5
200704-006,2007-04-13,-1,2007-04-13 11:05:00,2007-04-13 13:30:00,8021,7985,36
200704-007,2007-04-16,-1,2007-04-16 10:35:00,2007-04-16 13:30:00,8030,8065,-35
200704-008,2007-04-17,-1,2007-04-17 10:50:00,2007-04-17 13:30:00,8031,7964,67
200704-009,2007-04-19,-1,2007-04-19 09:40:00,2007-04-19 13:30:00,7930,7845,85
200704-010,2007-04-23,1,2007-04-23 10:00:00,2007-04-23 13:30:00,8008,8011,3
200704-011,2007-04-25,-1,2007-04-25 09:20:00,2007-04-25 13:30:00,7978,7964,14
200704-012,2007-04-27,-1,2007-04-27 09:20:00,2007-04-27 13:30:00,7973,7948,25
200704-013,2007-04-30,-1,2007-04-30 09:10:00,2007-04-30 13:30:00,7920,7846,74
200705-001,2007-05-03,-1,2007-05-03 11:10:00,2007-05-03 13:30:00,7890,7924,-34
200705-002,2007-05-04,1,2007-05-04 09:25:00,2007-05-04 13:30:00,8005,8067,62
200705-003,2007-05-07,1,2007-05-07 11:20:00,2007-05-07 13:30:00,8117,8116,-1
200705-004,2007-05-08,-1,2007-05-08 09:10:00,2007-05-08 12:25:00,8079,8107,-28
200705-005,2007-05-09,-1,2007-05-09 09:40:00,2007-05-09 13:30:00,8055,8061,-6
200705-006,2007-05-11,-1,2007-05-11 09:55:00,2007-05-11 13:15:00,8012,8040,-28
200705-007,2007-05-15,-1,2007-05-15 10:05:00,2007-05-15 13:30:00,7990,7955,35
200705-008,2007-05-17,1,2007-05-17 09:10:00,2007-05-17 13:30:00,8015,8015,0
200705-009,2007-05-18,-1,2007-05-18 09:55:00,2007-05-18 13:30:00,8007,8005,2
200705-010,2007-05-21,1,2007-05-21 10:25:00,2007-05-21 13:30:00,8080,8127,47
200705-011,2007-05-22,1,2007-05-22 09:10:00,2007-05-22 13:30:00,8135,8174,39
200705-012,2007-05-23,1,2007-05-23 09:10:00,2007-05-23 13:30:00,8205,8206,1
200705-013,2007-05-25,-1,2007-05-25 09:10:00,2007-05-25 12:15:00,8101,8137,-36
200705-014,2007-05-29,-1,2007-05-29 12:45:00,2007-05-29 13:30:00,8148,8160,-12
200705-015,2007-05-30,-1,2007-05-30 09:15:00,2007-05-30 13:30:00,8125,8101,24
200706-001,2007-06-01,1,2007-06-01 12:15:00,2007-06-01 13:30:00,8235,8236,1
200706-002,2007-06-04,1,2007-06-04 09:10:00,2007-06-04 13:30:00,8280,8260,-20
200706-003,2007-06-05,-1,2007-06-05 09:20:00,2007-06-05 09:40:00,8240,8269,-29
200706-004,2007-06-06,1,2007-06-06 09:10:00,2007-06-06 13:30:00,8271,8277,6
200706-005,2007-06-07,-1,2007-06-07 09:20:00,2007-06-07 11:45:00,8221,8265,-44
200706-006,2007-06-07,1,2007-06-07 13:15:00,2007-06-07 13:30:00,8327,8323,-4
200706-007,2007-06-08,-1,2007-06-08 09:25:00,2007-06-08 13:30:00,8231,8270,-39
200706-008,2007-06-12,1,2007-06-12 09:30:00,2007-06-12 13:30:00,8332,8343,11
200706-009,2007-06-13,1,2007-06-13 09:50:00,2007-06-13 13:30:00,8350,8335,-15
200706-010,2007-06-14,1,2007-06-14 09:35:00,2007-06-14 13:30:00,8399,8435,36
200706-011,2007-06-15,1,2007-06-15 09:10:00,2007-06-15 13:30:00,8494,8582,88
200706-012,2007-06-20,1,2007-06-20 11:50:00,2007-06-20 13:30:00,8675,8786,111
200706-013,2007-06-21,1,2007-06-21 11:30:00,2007-06-21 13:30:00,8816,8846,30
200706-014,2007-06-25,1,2007-06-25 09:10:00,2007-06-25 13:30:00,8900,8933,33
200706-015,2007-06-26,-1,2007-06-26 09:25:00,2007-06-26 13:30:00,8879,8834,45
200706-016,2007-06-27,-1,2007-06-27 12:40:00,2007-06-27 13:30:00,8772,8777,-5
200706-017,2007-06-29,-1,2007-06-29 10:45:00,2007-06-29 13:30:00,8792,8808,-16
200707-001,2007-07-02,1,2007-07-02 12:30:00,2007-07-02 13:30:00,8859,8867,8
200707-002,2007-07-03,1,2007-07-03 11:05:00,2007-07-03 13:30:00,8987,8979,-8
200707-003,2007-07-04,1,2007-07-04 09:25:00,2007-07-04 13:30:00,9049,9045,-4
200707-004,2007-07-06,1,2007-07-06 09:35:00,2007-07-06 13:30:00,9129,9136,7
200707-005,2007-07-09,1,2007-07-09 09:50:00,2007-07-09 13:30:00,9208,9343,135
200707-006,2007-07-11,-1,2007-07-11 09:55:00,2007-07-11 13:30:00,9266,9238,28
200707-007,2007-07-16,1,2007-07-16 10:40:00,2007-07-16 12:40:00,9505,9430,-75
200707-008,2007-07-16,-1,2007-07-16 13:10:00,2007-07-16 13:30:00,9426,9393,33
200707-009,2007-07-17,-1,2007-07-17 09:10:00,2007-07-17 11:30:00,9370,9411,-41
200707-010,2007-07-17,1,2007-07-17 13:20:00,2007-07-17 13:30:00,9510,9522,12
200707-011,2007-07-19,-1,2007-07-19 09:10:00,2007-07-19 13:30:00,9398,9395,3
200707-012,2007-07-20,1,2007-07-20 12:05:00,2007-07-20 13:30:00,9501,9525,24
200707-013,2007-07-23,1,2007-07-23 10:35:00,2007-07-23 13:30:00,9548,9557,9
200707-014,2007-07-24,1,2007-07-24 09:55:00,2007-07-24 13:30:00,9595,9645,50
200707-015,2007-07-25,1,2007-07-25 12:30:00,2007-07-25 13:30:00,9698,9737,39
200707-016,2007-07-26,-1,2007-07-26 11:55:00,2007-07-26 13:30:00,9670,9533,137
200707-017,2007-07-27,-1,2007-07-27 13:10:00,2007-07-27 13:30:00,9166,8966,200
200707-018,2007-07-30,-1,2007-07-30 12:30:00,2007-07-30 12:45:00,8866,8955,-89
200707-019,2007-07-31,1,2007-07-31 11:00:00,2007-07-31 13:30:00,9135,9178,43
200708-001,2007-08-01,-1,2007-08-01 11:35:00,2007-08-01 13:30:00,9005,8720,285
200708-002,2007-08-02,-1,2007-08-02 12:10:00,2007-08-02 12:45:00,8641,8728,-87
200708-003,2007-08-03,1,2007-08-03 09:55:00,2007-08-03 11:00:00,9028,8937,-91
200708-004,2007-08-07,-1,2007-08-07 12:20:00,2007-08-07 12:40:00,8791,8879,-88
200708-005,2007-08-07,-1,2007-08-07 12:50:00,2007-08-07 13:10:00,8781,8869,-88
200708-006,2007-08-08,1,2007-08-08 12:10:00,2007-08-08 13:30:00,8982,9070,88
200708-007,2007-08-10,-1,2007-08-10 09:15:00,2007-08-10 12:20:00,8820,8845,-25
200708-008,2007-08-13,1,2007-08-13 12:25:00,2007-08-13 13:30:00,8960,8916,-44
200708-009,2007-08-14,-1,2007-08-14 09:25:00,2007-08-14 10:05:00,8842,8931,-89
200708-010,2007-08-14,1,2007-08-14 10:10:00,2007-08-14 10:15:00,9019,8928,-91
200708-011,2007-08-15,-1,2007-08-15 10:50:00,2007-08-15 13:30:00,8700,8566,134
200708-012,2007-08-16,-1,2007-08-16 09:30:00,2007-08-16 13:30:00,8207,8110,97
200708-013,2007-08-17,-1,2007-08-17 11:30:00,2007-08-17 13:30:00,8001,8005,-4
200708-014,2007-08-21,-1,2007-08-21 12:40:00,2007-08-21 13:30:00,8356,8348,8
200708-015,2007-08-24,-1,2007-08-24 11:40:00,2007-08-24 13:30:00,8597,8610,-13
200708-016,2007-08-27,-1,2007-08-27 12:55:00,2007-08-27 13:30:00,8674,8643,31
200708-017,2007-08-28,-1,2007-08-28 09:15:00,2007-08-28 10:40:00,8620,8689,-69
200708-018,2007-08-28,-1,2007-08-28 12:50:00,2007-08-28 13:30:00,8606,8637,-31
200708-019,2007-08-29,-1,2007-08-29 09:35:00,2007-08-29 12:00:00,8460,8503,-43
200708-020,2007-08-30,1,2007-08-30 09:35:00,2007-08-30 13:30:00,8723,8708,-15
200708-021,2007-08-31,1,2007-08-31 09:55:00,2007-08-31 13:30:00,8785,8960,175
200709-001,2007-09-04,-1,2007-09-04 10:35:00,2007-09-04 13:05:00,8887,8945,-58
200709-002,2007-09-05,-1,2007-09-05 12:40:00,2007-09-05 13:30:00,8890,8834,56
200709-003,2007-09-06,-1,2007-09-06 09:10:00,2007-09-06 10:15:00,8785,8873,-88
200709-004,2007-09-13,-1,2007-09-13 10:55:00,2007-09-13 13:30:00,8896,8900,-4
200709-005,2007-09-14,1,2007-09-14 11:40:00,2007-09-14 13:30:00,9013,9045,32
200709-006,2007-09-17,-1,2007-09-17 11:00:00,2007-09-17 13:30:00,8935,8870,65
200709-007,2007-09-20,-1,2007-09-20 13:20:00,2007-09-20 13:30:00,8990,9008,-18
200709-008,2007-09-26,1,2007-09-26 09:20:00,2007-09-26 13:30:00,9227,9287,60
200709-009,2007-09-27,1,2007-09-27 10:40:00,2007-09-27 13:30:00,9353,9411,58
200709-010,2007-09-28,1,2007-09-28 12:10:00,2007-09-28 13:30:00,9466,9394,-72
200709-011,2007-09-29,1,2007-09-29 09:45:00,2007-09-29 13:30:00,9472,9489,17
200710-001,2007-10-02,1,2007-10-02 10:15:00,2007-10-02 13:30:00,9632,9673,41
200710-002,2007-10-03,1,2007-10-03 11:25:00,2007-10-03 13:30:00,9754,9747,-7
200710-003,2007-10-04,-1,2007-10-04 11:15:00,2007-10-04 13:30:00,9652,9670,-18
200710-004,2007-10-08,1,2007-10-08 09:15:00,2007-10-08 13:30:00,9728,9745,17
200710-005,2007-10-09,-1,2007-10-09 09:10:00,2007-10-09 13:10:00,9708,9663,45
200710-006,2007-10-12,-1,2007-10-12 11:05:00,2007-10-12 13:30:00,9639,9462,177
200710-007,2007-10-15,-1,2007-10-15 09:45:00,2007-10-15 10:20:00,9418,9513,-95
200710-008,2007-10-16,1,2007-10-16 10:15:00,2007-10-16 13:30:00,9568,9566,-2
200710-009,2007-10-18,1,2007-10-18 09:15:00,2007-10-18 13:30:00,9650,9670,20
200710-010,2007-10-23,1,2007-10-23 11:40:00,2007-10-23 13:30:00,9461,9537,76
200710-011,2007-10-24,1,2007-10-24 09:10:00,2007-10-24 12:30:00,9594,9498,-96
200710-012,2007-10-24,-1,2007-10-24 12:40:00,2007-10-24 13:30:00,9497,9442,55
200710-013,2007-10-26,1,2007-10-26 09:20:00,2007-10-26 13:30:00,9674,9660,-14
200710-014,2007-10-29,1,2007-10-29 09:10:00,2007-10-29 13:30:00,9795,9845,50
200711-001,2007-11-01,-1,2007-11-01 10:30:00,2007-11-01 13:30:00,9720,9655,65
200711-002,2007-11-02,-1,2007-11-02 09:10:00,2007-11-02 13:30:00,9437,9249,188
200711-003,2007-11-05,-1,2007-11-05 09:40:00,2007-11-05 12:50:00,9167,9243,-76
200711-004,2007-11-08,-1,2007-11-08 10:05:00,2007-11-08 13:30:00,8989,8893,96
200711-005,2007-11-12,-1,2007-11-12 09:15:00,2007-11-12 13:30:00,8666,8637,29
200711-006,2007-11-13,-1,2007-11-13 12:10:00,2007-11-13 12:45:00,8573,8659,-86
200711-007,2007-11-13,1,2007-11-13 13:05:00,2007-11-13 13:30:00,8733,8756,23
200711-008,2007-11-15,-1,2007-11-15 09:55:00,2007-11-15 13:30:00,8888,8880,8
200711-009,2007-11-21,-1,2007-11-21 12:40:00,2007-11-21 13:30:00,8517,8456,61
200711-010,2007-11-22,-1,2007-11-22 09:35:00,2007-11-22 09:55:00,8350,8434,-84
200711-011,2007-11-23,-1,2007-11-23 09:25:00,2007-11-23 13:30:00,8441,8338,103
200711-012,2007-11-26,1,2007-11-26 12:20:00,2007-11-26 13:30:00,8538,8550,12
200711-013,2007-11-27,-1,2007-11-27 09:15:00,2007-11-27 11:10:00,8248,8331,-83
200711-014,2007-11-28,-1,2007-11-28 11:35:00,2007-11-28 12:15:00,8291,8374,-83
200711-015,2007-11-30,1,2007-11-30 09:25:00,2007-11-30 13:30:00,8580,8590,10
200712-001,2007-12-03,-1,2007-12-03 12:55:00,2007-12-03 13:30:00,8562,8576,-14
200712-002,2007-12-04,1,2007-12-04 12:55:00,2007-12-04 13:30:00,8637,8636,-1
200712-003,2007-12-05,1,2007-12-05 10:55:00,2007-12-05 13:30:00,8649,8703,54
200712-004,2007-12-06,-1,2007-12-06 12:50:00,2007-12-06 13:30:00,8706,8711,-5
200712-005,2007-12-07,1,2007-12-07 09:55:00,2007-12-07 13:30:00,8808,8748,-60
200712-006,2007-12-10,-1,2007-12-10 09:30:00,2007-12-10 13:30:00,8662,8576,86
200712-007,2007-12-12,-1,2007-12-12 10:50:00,2007-12-12 13:10:00,8464,8522,-58
200712-008,2007-12-13,-1,2007-12-13 10:25:00,2007-12-13 13:30:00,8432,8128,304
200712-009,2007-12-14,-1,2007-12-14 10:25:00,2007-12-14 10:55:00,8055,8136,-81
200712-010,2007-12-14,-1,2007-12-14 12:10:00,2007-12-14 12:25:00,7913,7993,-80
200712-011,2007-12-17,-1,2007-12-17 12:50:00,2007-12-17 13:30:00,7861,7787,74
200712-012,2007-12-19,1,2007-12-19 10:20:00,2007-12-19 13:30:00,7968,8021,53
200712-013,2007-12-20,-1,2007-12-20 10:30:00,2007-12-20 13:30:00,7943,7799,144
200712-014,2007-12-24,1,2007-12-24 11:25:00,2007-12-24 13:30:00,8120,8119,-1
200712-015,2007-12-26,-1,2007-12-26 09:25:00,2007-12-26 12:05:00,8080,8103,-23
200712-016,2007-12-26,1,2007-12-26 13:20:00,2007-12-26 13:30:00,8154,8180,26
200712-017,2007-12-27,1,2007-12-27 09:15:00,2007-12-27 13:30:00,8216,8321,105
200712-018,2007-12-28,1,2007-12-28 09:20:00,2007-12-28 10:10:00,8377,8293,-84
200712-019,2007-12-31,1,2007-12-31 09:20:00,2007-12-31 13:30:00,8446,8479,33
200801-001,2008-01-02,1,2008-01-02 11:45:00,2008-01-02 12:15:00,8503,8421,-82
200801-002,2008-01-02,-1,2008-01-02 12:20:00,2008-01-02 13:30:00,8406,8300,106
200801-003,2008-01-04,1,2008-01-04 11:35:00,2008-01-04 13:30:00,8229,8208,-21
200801-004,2008-01-07,-1,2008-01-07 10:00:00,2008-01-07 13:30:00,7935,7825,110
200801-005,2008-01-09,1,2008-01-09 10:10:00,2008-01-09 13:30:00,7964,8065,101
200801-006,2008-01-10,1,2008-01-10 09:15:00,2008-01-10 11:55:00,8150,8068,-82
200801-007,2008-01-11,1,2008-01-11 09:10:00,2008-01-11 11:45:00,8155,8073,-82
200801-008,2008-01-11,-1,2008-01-11 12:05:00,2008-01-11 13:30:00,8026,7986,40
200801-009,2008-01-15,1,2008-01-15 09:15:00,2008-01-15 13:30:00,8350,8486,136
200801-010,2008-01-16,-1,2008-01-16 13:10:00,2008-01-16 13:30:00,8185,8162,23
200801-011,2008-01-17,-1,2008-01-17 10:20:00,2008-01-17 13:30:00,8125,8100,25
200801-012,2008-01-18,-1,2008-01-18 09:10:00,2008-01-18 10:35:00,7867,7946,-79
200801-013,2008-01-18,1,2008-01-18 13:10:00,2008-01-18 13:30:00,8181,8218,37
200801-014,2008-01-23,-1,2008-01-23 10:55:00,2008-01-23 13:30:00,7543,7346,197
200801-015,2008-01-25,1,2008-01-25 09:25:00,2008-01-25 13:30:00,7693,7765,72
200801-016,2008-01-28,-1,2008-01-28 09:50:00,2008-01-28 13:30:00,7633,7418,215
200801-017,2008-01-30,1,2008-01-30 09:35:00,2008-01-30 11:20:00,7598,7522,-76
200801-018,2008-01-30,-1,2008-01-30 12:30:00,2008-01-30 13:30:00,7485,7503,-18
200801-019,2008-01-31,-1,2008-01-31 11:20:00,2008-01-31 12:05:00,7353,7427,-74
200802-001,2008-02-01,1,2008-02-01 09:15:00,2008-02-01 13:30:00,7584,7675,91
200802-002,2008-02-12,-1,2008-02-12 09:55:00,2008-02-12 13:30:00,7491,7494,-3
200802-003,2008-02-13,-1,2008-02-13 13:15:00,2008-02-13 13:30:00,7502,7491,11
200802-004,2008-02-14,1,2008-02-14 10:00:00,2008-02-14 13:30:00,7755,7891,136
200802-005,2008-02-19,1,2008-02-19 11:15:00,2008-02-19 13:30:00,7999,8022,23
200802-006,2008-02-20,-1,2008-02-20 12:40:00,2008-02-20 13:30:00,7877,7853,24
200802-007,2008-02-21,1,2008-02-21 12:00:00,2008-02-21 13:30:00,8005,8051,46
200802-008,2008-02-22,-1,2008-02-22 09:15:00,2008-02-22 13:05:00,7940,8008,-68
200802-009,2008-02-25,1,2008-02-25 09:10:00,2008-02-25 13:30:00,8199,8240,41
200802-010,2008-02-27,1,2008-02-27 11:30:00,2008-02-27 13:30:00,8395,8387,-8
200802-011,2008-02-29,1,2008-02-29 12:40:00,2008-02-29 13:30:00,8415,8387,-28
200803-001,2008-03-03,-1,2008-03-03 09:20:00,2008-03-03 11:40:00,8142,8176,-34
200803-002,2008-03-04,1,2008-03-04 10:40:00,2008-03-04 13:30:00,8420,8477,57
200803-003,2008-03-05,1,2008-03-05 09:25:00,2008-03-05 11:45:00,8523,8437,-86
200803-004,2008-03-06,1,2008-03-06 09:15:00,2008-03-06 13:30:00,8558,8665,107
200803-005,2008-03-10,-1,2008-03-10 09:55:00,2008-03-10 13:30:00,8444,8256,188
200803-006,2008-03-12,-1,2008-03-12 12:35:00,2008-03-12 13:30:00,8430,8459,-29
200803-007,2008-03-13,-1,2008-03-13 09:15:00,2008-03-13 13:30:00,8405,8170,235
200803-008,2008-03-14,-1,2008-03-14 12:15:00,2008-03-14 13:30:00,8161,8131,30
200803-009,2008-03-17,-1,2008-03-17 10:30:00,2008-03-17 11:45:00,7860,7939,-79
200803-010,2008-03-18,1,2008-03-18 13:05:00,2008-03-18 13:30:00,8056,8066,10
200803-011,2008-03-19,-1,2008-03-19 13:20:00,2008-03-19 13:30:00,8148,8151,-3
200803-012,2008-03-20,-1,2008-03-20 10:45:00,2008-03-20 12:05:00,8060,8141,-81
200803-013,2008-03-20,1,2008-03-20 12:40:00,2008-03-20 13:30:00,8239,8351,112
200803-014,2008-03-21,1,2008-03-21 09:50:00,2008-03-21 13:30:00,8456,8530,74
200803-015,2008-03-26,-1,2008-03-26 12:10:00,2008-03-26 13:30:00,8731,8715,16
200803-016,2008-03-27,-1,2008-03-27 09:10:00,2008-03-27 13:30:00,8675,8562,113
200803-017,2008-03-31,-1,2008-03-31 10:35:00,2008-03-31 11:50:00,8462,8547,-85
200804-001,2008-04-01,-1,2008-04-01 12:05:00,2008-04-01 13:30:00,8467,8360,107
200804-002,2008-04-02,1,2008-04-02 11:30:00,2008-04-02 13:30:00,8595,8598,3
200804-003,2008-04-07,1,2008-04-07 10:15:00,2008-04-07 13:30:00,8670,8726,56
200804-004,2008-04-09,1,2008-04-09 10:20:00,2008-04-09 12:20:00,8753,8665,-88
200804-005,2008-04-09,-1,2008-04-09 12:25:00,2008-04-09 13:30:00,8633,8664,-31
200804-006,2008-04-10,1,2008-04-10 10:35:00,2008-04-10 13:30:00,8780,8795,15
200804-007,2008-04-11,1,2008-04-11 12:30:00,2008-04-11 13:30:00,8898,8893,-5
200804-008,2008-04-15,1,2008-04-15 12:40:00,2008-04-15 13:30:00,8931,8920,-11
200804-009,2008-04-16,1,2008-04-16 11:30:00,2008-04-16 13:30:00,9014,9072,58
200804-010,2008-04-17,-1,2008-04-17 12:50:00,2008-04-17 13:30:00,9047,9060,-13
200804-011,2008-04-18,-1,2008-04-18 10:25:00,2008-04-18 13:15:00,9038,9063,-25
200804-012,2008-04-22,-1,2008-04-22 09:10:00,2008-04-22 12:45:00,9044,9038,6
200804-013,2008-04-23,-1,2008-04-23 09:20:00,2008-04-23 11:20:00,8977,9067,-90
200804-014,2008-04-23,1,2008-04-23 11:25:00,2008-04-23 13:30:00,9070,8995,-75
200804-015,2008-04-25,-1,2008-04-25 11:20:00,2008-04-25 13:30:00,8960,8963,-3
200804-016,2008-04-28,1,2008-04-28 11:45:00,2008-04-28 13:30:00,9068,9059,-9
200804-017,2008-04-29,-1,2008-04-29 12:20:00,2008-04-29 13:30:00,8995,8915,80
200805-001,2008-05-05,-1,2008-05-05 09:55:00,2008-05-05 13:30:00,8936,8848,88
200805-002,2008-05-07,1,2008-05-07 09:35:00,2008-05-07 13:30:00,8925,8933,8
200805-003,2008-05-08,-1,2008-05-08 09:10:00,2008-05-08 13:25:00,8841,8885,-44
200805-004,2008-05-09,-1,2008-05-09 10:00:00,2008-05-09 13:30:00,8800,8787,13
200805-005,2008-05-13,1,2008-05-13 09:45:00,2008-05-13 13:30:00,8898,9028,130
200805-006,2008-05-14,1,2008-05-14 09:10:00,2008-05-14 13:30:00,9044,9059,15
200805-007,2008-05-15,1,2008-05-15 09:25:00,2008-05-15 13:30:00,9147,9205,58
200805-008,2008-05-16,1,2008-05-16 10:05:00,2008-05-16 13:30:00,9227,9257,30
200805-009,2008-05-20,-1,2008-05-20 10:00:00,2008-05-20 13:30:00,9253,9105,148
200805-010,2008-05-21,-1,2008-05-21 09:20:00,2008-05-21 11:45:00,9013,9088,-75
200805-011,2008-05-23,-1,2008-05-23 11:20:00,2008-05-23 13:30:00,8892,8818,74
200805-012,2008-05-26,-1,2008-05-26 10:40:00,2008-05-26 13:30:00,8702,8718,-16
200805-013,2008-05-28,-1,2008-05-28 09:50:00,2008-05-28 13:30:00,8706,8638,68
200805-014,2008-05-30,-1,2008-05-30 10:45:00,2008-05-30 13:10:00,8585,8664,-79
200806-001,2008-06-03,-1,2008-06-03 09:45:00,2008-06-03 13:30:00,8610,8560,50
200806-002,2008-06-05,-1,2008-06-05 10:25:00,2008-06-05 12:20:00,8490,8567,-77
200806-003,2008-06-05,1,2008-06-05 12:30:00,2008-06-05 13:30:00,8619,8760,141
200806-004,2008-06-09,-1,2008-06-09 09:15:00,2008-06-09 12:35:00,8494,8548,-54
200806-005,2008-06-10,-1,2008-06-10 10:45:00,2008-06-10 13:30:00,8416,8328,88
200806-006,2008-06-11,-1,2008-06-11 09:30:00,2008-06-11 11:20:00,8321,8382,-61
200806-007,2008-06-12,-1,2008-06-12 09:10:00,2008-06-12 13:30:00,8181,8016,165
200806-008,2008-06-16,1,2008-06-16 09:25:00,2008-06-16 13:30:00,8145,8128,-17
200806-009,2008-06-17,-1,2008-06-17 09:15:00,2008-06-17 12:40:00,8100,8139,-39
200806-010,2008-06-18,1,2008-06-18 12:35:00,2008-06-18 13:30:00,8250,8220,-30
200806-011,2008-06-19,-1,2008-06-19 09:40:00,2008-06-19 13:30:00,7895,7916,-21
200806-012,2008-06-20,-1,2008-06-20 09:20:00,2008-06-20 10:45:00,7850,7929,-79
200806-013,2008-06-20,-1,2008-06-20 12:25:00,2008-06-20 13:30:00,7818,7733,85
200806-014,2008-06-23,-1,2008-06-23 09:15:00,2008-06-23 09:40:00,7643,7720,-77
200806-015,2008-06-24,-1,2008-06-24 10:40:00,2008-06-24 13:30:00,7666,7678,-12
200806-016,2008-06-25,1,2008-06-25 13:15:00,2008-06-25 13:30:00,7748,7751,3
200806-017,2008-06-26,1,2008-06-26 10:00:00,2008-06-26 13:15:00,7790,7712,-78
200806-018,2008-06-30,-1,2008-06-30 13:20:00,2008-06-30 13:30:00,7400,7399,1
200807-001,2008-07-01,-1,2008-07-01 11:15:00,2008-07-01 13:30:00,7380,7320,60
200807-002,2008-07-02,-1,2008-07-02 09:15:00,2008-07-02 09:25:00,7286,7359,-73
200807-003,2008-07-02,-1,2008-07-02 12:35:00,2008-07-02 13:30:00,7273,7293,-20
200807-004,2008-07-03,-1,2008-07-03 09:10:00,2008-07-03 09:55:00,7062,7133,-71
200807-005,2008-07-03,1,2008-07-03 13:20:00,2008-07-03 13:30:00,7364,7329,-35
200807-006,2008-07-04,-1,2008-07-04 13:10:00,2008-07-04 13:30:00,7167,7125,42
200807-007,2008-07-08,-1,2008-07-08 10:15:00,2008-07-08 13:30:00,7133,6961,172
200807-008,2008-07-11,1,2008-07-11 12:35:00,2008-07-11 13:30:00,7153,7176,23
200807-009,2008-07-14,1,2008-07-14 09:50:00,2008-07-14 11:35:00,7210,7137,-73
200807-010,2008-07-14,-1,2008-07-14 12:15:00,2008-07-14 13:30:00,7120,7139,-19
200807-011,2008-07-15,-1,2008-07-15 09:10:00,2008-07-15 13:30:00,6980,6800,180
200807-012,2008-07-17,1,2008-07-17 12:50:00,2008-07-17 13:30:00,6828,6830,2
200807-013,2008-07-18,1,2008-07-18 10:00:00,2008-07-18 10:50:00,6872,6803,-69
200807-014,2008-07-18,-1,2008-07-18 11:55:00,2008-07-18 13:30:00,6768,6648,120
200807-015,2008-07-21,1,2008-07-21 09:20:00,2008-07-21 13:30:00,6919,7000,81
200807-016,2008-07-22,-1,2008-07-22 09:55:00,2008-07-22 10:40:00,6894,6963,-69
200807-017,2008-07-23,1,2008-07-23 09:10:00,2008-07-23 13:30:00,7115,7191,76
200807-018,2008-07-25,-1,2008-07-25 09:15:00,2008-07-25 13:30:00,7145,7146,-1
200807-019,2008-07-29,-1,2008-07-29 09:30:00,2008-07-29 12:35:00,6898,6930,-32
200807-020,2008-07-31,1,2008-07-31 09:25:00,2008-07-31 10:05:00,7140,7068,-72
200807-021,2008-07-31,-1,2008-07-31 11:10:00,2008-07-31 13:30:00,6988,6995,-7
200808-001,2008-08-05,-1,2008-08-05 09:40:00,2008-08-05 13:30:00,6890,6794,96
200808-002,2008-08-06,1,2008-08-06 13:10:00,2008-08-06 13:30:00,7025,7011,-14
200808-003,2008-08-07,1,2008-08-07 09:50:00,2008-08-07 11:50:00,7048,6977,-71
200808-004,2008-08-08,1,2008-08-08 09:20:00,2008-08-08 13:30:00,7055,7183,128
200808-005,2008-08-11,1,2008-08-11 09:15:00,2008-08-11 13:30:00,7299,7300,1
200808-006,2008-08-13,-1,2008-08-13 11:20:00,2008-08-13 13:30:00,7223,7274,-51
200808-007,2008-08-15,-1,2008-08-15 12:10:00,2008-08-15 13:30:00,7295,7200,95
200808-008,2008-08-18,-1,2008-08-18 09:20:00,2008-08-18 13:30:00,7155,6986,169
200808-009,2008-08-19,-1,2008-08-19 09:10:00,2008-08-19 09:40:00,6820,6889,-69
200808-010,2008-08-20,1,2008-08-20 11:55:00,2008-08-20 13:30:00,7009,7045,36
200808-011,2008-08-21,-1,2008-08-21 12:05:00,2008-08-21 13:30:00,6873,6885,-12
200808-012,2008-08-22,-1,2008-08-22 11:05:00,2008-08-22 12:25:00,6781,6849,-68
200808-013,2008-08-25,1,2008-08-25 11:35:00,2008-08-25 13:30:00,7010,7003,-7
200808-014,2008-08-27,1,2008-08-27 09:50:00,2008-08-27 13:30:00,7037,7080,43
200808-015,2008-08-29,1,2008-08-29 09:15:00,2008-08-29 10:30:00,7138,7066,-72
200808-016,2008-08-29,-1,2008-08-29 11:10:00,2008-08-29 13:30:00,7034,7041,-7
200809-001,2008-09-01,-1,2008-09-01 09:15:00,2008-09-01 13:30:00,6922,6760,162
200809-002,2008-09-02,-1,2008-09-02 09:35:00,2008-09-02 13:30:00,6731,6692,39
200809-003,2008-09-03,-1,2008-09-03 12:15:00,2008-09-03 13:30:00,6571,6570,1
200809-004,2008-09-04,-1,2008-09-04 11:20:00,2008-09-04 13:30:00,6490,6378,112
200809-005,2008-09-08,1,2008-09-08 09:20:00,2008-09-08 13:30:00,6533,6677,144
200809-006,2008-09-09,-1,2008-09-09 09:15:00,2008-09-09 13:30:00,6550,6413,137
200809-007,2008-09-11,-1,2008-09-11 10:50:00,2008-09-11 13:30:00,6246,6240,6
200809-008,2008-09-12,-1,2008-09-12 10:20:00,2008-09-12 11:05:00,6203,6266,-63
200809-009,2008-09-15,-1,2008-09-15 10:50:00,2008-09-15 13:30:00,6076,5946,130
200809-010,2008-09-17,-1,2008-09-17 09:50:00,2008-09-17 13:30:00,5863,5758,105
200809-011,2008-09-19,1,2008-09-19 11:55:00,2008-09-19 13:30:00,5908,5908,0
200809-012,2008-09-24,1,2008-09-24 10:55:00,2008-09-24 12:40:00,6155,6093,-62
200809-013,2008-09-26,-1,2008-09-26 09:10:00,2008-09-26 13:30:00,6018,5844,174
200810-001,2008-10-02,-1,2008-10-02 12:35:00,2008-10-02 13:30:00,5588,5587,1
200810-002,2008-10-03,-1,2008-10-03 09:15:00,2008-10-03 10:50:00,5525,5581,-56
200810-003,2008-10-03,1,2008-10-03 13:00:00,2008-10-03 13:30:00,5650,5671,21
200810-004,2008-10-06,-1,2008-10-06 09:15:00,2008-10-06 13:30:00,5444,5406,38
200810-005,2008-10-07,1,2008-10-07 13:00:00,2008-10-07 13:30:00,5484,5469,-15
200810-006,2008-10-08,-1,2008-10-08 11:40:00,2008-10-08 13:30:00,5236,5106,130
200810-007,2008-10-09,-1,2008-10-09 12:50:00,2008-10-09 13:30:00,5087,5088,-1
200810-008,2008-10-15,-1,2008-10-15 09:10:00,2008-10-15 13:30:00,5206,5213,-7
200810-009,2008-10-17,-1,2008-10-17 12:30:00,2008-10-17 13:30:00,4811,4804,7
200810-010,2008-10-20,-1,2008-10-20 09:10:00,2008-10-20 12:25:00,4720,4705,15
200810-011,2008-10-21,1,2008-10-21 09:15:00,2008-10-21 09:35:00,4949,4899,-50
200810-012,2008-10-21,-1,2008-10-21 12:20:00,2008-10-21 13:05:00,4754,4802,-48
200810-013,2008-10-22,-1,2008-10-22 13:05:00,2008-10-22 13:30:00,4695,4650,45
200810-014,2008-10-23,-1,2008-10-23 09:10:00,2008-10-23 13:00:00,4494,4502,-8
200810-015,2008-10-24,-1,2008-10-24 09:25:00,2008-10-24 13:30:00,4366,4337,29
200810-016,2008-10-28,-1,2008-10-28 09:10:00,2008-10-28 10:05:00,3893,3932,-39
200810-017,2008-10-31,1,2008-10-31 09:10:00,2008-10-31 10:05:00,4640,4593,-47
200811-001,2008-11-04,-1,2008-11-04 10:05:00,2008-11-04 11:05:00,4852,4901,-49
200811-002,2008-11-04,1,2008-11-04 13:05:00,2008-11-04 13:30:00,4994,4987,-7
200811-003,2008-11-05,-1,2008-11-05 13:05:00,2008-11-05 13:30:00,4910,4923,-13
200811-004,2008-11-12,-1,2008-11-12 11:55:00,2008-11-12 12:35:00,4473,4518,-45
200811-005,2008-11-18,-1,2008-11-18 09:15:00,2008-11-18 13:30:00,4293,4241,52
200811-006,2008-11-21,-1,2008-11-21 09:10:00,2008-11-21 09:20:00,3826,3865,-39
200811-007,2008-11-21,1,2008-11-21 12:25:00,2008-11-21 13:30:00,4027,4089,62
200811-008,2008-11-24,-1,2008-11-24 11:45:00,2008-11-24 11:50:00,3977,4017,-40
200811-009,2008-11-27,1,2008-11-27 09:45:00,2008-11-27 13:30:00,4369,4443,74
200812-001,2008-12-09,1,2008-12-09 10:50:00,2008-12-09 11:45:00,4508,4462,-46
200812-002,2008-12-10,1,2008-12-10 09:50:00,2008-12-10 13:30:00,4582,4713,131
200812-003,2008-12-12,-1,2008-12-12 11:25:00,2008-12-12 13:30:00,4562,4408,154
200812-004,2008-12-17,1,2008-12-17 09:10:00,2008-12-17 11:25:00,4704,4656,-48
200812-005,2008-12-18,-1,2008-12-18 09:45:00,2008-12-18 13:30:00,4620,4646,-26
200812-006,2008-12-19,1,2008-12-19 12:25:00,2008-12-19 13:00:00,4705,4657,-48
200812-007,2008-12-19,1,2008-12-19 13:15:00,2008-12-19 13:30:00,4720,4680,-40
200812-008,2008-12-22,-1,2008-12-22 11:25:00,2008-12-22 13:30:00,4613,4507,106
200812-009,2008-12-23,-1,2008-12-23 09:10:00,2008-12-23 13:30:00,4481,4372,109
200812-010,2008-12-26,1,2008-12-26 10:10:00,2008-12-26 12:50:00,4405,4360,-45
200812-011,2008-12-29,-1,2008-12-29 09:10:00,2008-12-29 12:45:00,4332,4355,-23
200812-012,2008-12-30,1,2008-12-30 09:10:00,2008-12-30 13:30:00,4456,4570,114
200812-013,2008-12-31,-1,2008-12-31 12:30:00,2008-12-31 13:30:00,4502,4532,-30
200901-001,2009-01-05,1,2009-01-05 09:20:00,2009-01-05 10:50:00,4745,4697,-48
200901-002,2009-01-06,-1,2009-01-06 12:15:00,2009-01-06 13:30:00,4650,4694,-44
200901-003,2009-01-07,1,2009-01-07 09:35:00,2009-01-07 09:45:00,4795,4747,-48
200901-004,2009-01-08,-1,2009-01-08 09:55:00,2009-01-08 13:30:00,4598,4460,138
200901-005,2009-01-09,-1,2009-01-09 09:20:00,2009-01-09 09:40:00,4412,4457,-45
200901-006,2009-01-12,-1,2009-01-12 10:50:00,2009-01-12 11:50:00,4355,4399,-44
200901-007,2009-01-14,1,2009-01-14 09:20:00,2009-01-14 11:55:00,4524,4478,-46
200901-008,2009-01-17,1,2009-01-17 12:55:00,2009-01-17 13:30:00,4354,4335,-19
200901-009,2009-01-19,-1,2009-01-19 12:05:00,2009-01-19 13:30:00,4328,4348,-20
200902-001,2009-02-03,1,2009-02-03 09:25:00,2009-02-03 13:30:00,4265,4279,14
200902-002,2009-02-04,1,2009-02-04 12:40:00,2009-02-04 13:30:00,4350,4354,4
200902-003,2009-02-06,1,2009-02-06 09:15:00,2009-02-06 13:30:00,4389,4422,33
200902-004,2009-02-11,1,2009-02-11 12:55:00,2009-02-11 13:30:00,4507,4563,56
200902-005,2009-02-12,-1,2009-02-12 11:25:00,2009-02-12 13:30:00,4435,4433,2
200902-006,2009-02-13,1,2009-02-13 12:45:00,2009-02-13 13:30:00,4565,4573,8
200902-007,2009-02-17,-1,2009-02-17 09:30:00,2009-02-17 13:30:00,4512,4480,32
200902-008,2009-02-18,1,2009-02-18 13:10:00,2009-02-18 13:30:00,4515,4517,2
200902-009,2009-02-20,-1,2009-02-20 09:35:00,2009-02-20 11:00:00,4383,4427,-44
200902-010,2009-02-20,-1,2009-02-20 12:30:00,2009-02-20 13:30:00,4362,4369,-7
200902-011,2009-02-23,-1,2009-02-23 09:20:00,2009-02-23 09:25:00,4302,4346,-44
200902-012,2009-02-25,1,2009-02-25 09:10:00,2009-02-25 12:15:00,4458,4413,-45
200902-013,2009-02-26,-1,2009-02-26 13:15:00,2009-02-26 13:30:00,4445,4463,-18
200903-001,2009-03-02,-1,2009-03-02 11:20:00,2009-03-02 13:30:00,4401,4332,69
200903-002,2009-03-03,-1,2009-03-03 09:30:00,2009-03-03 09:50:00,4250,4293,-43
200903-003,2009-03-04,1,2009-03-04 10:25:00,2009-03-04 13:30:00,4448,4504,56
200903-004,2009-03-05,1,2009-03-05 09:10:00,2009-03-05 13:30:00,4586,4595,9
200903-005,2009-03-09,-1,2009-03-09 09:40:00,2009-03-09 12:55:00,4562,4584,-22
200903-006,2009-03-10,1,2009-03-10 12:45:00,2009-03-10 13:30:00,4656,4654,-2
200903-007,2009-03-12,-1,2009-03-12 12:45:00,2009-03-12 13:30:00,4738,4754,-16
200903-008,2009-03-13,1,2009-03-13 09:15:00,2009-03-13 13:30:00,4844,4896,52
200903-009,2009-03-16,1,2009-03-16 10:05:00,2009-03-16 13:30:00,4943,4959,16
200903-010,2009-03-17,1,2009-03-17 12:50:00,2009-03-17 13:30:00,5036,5066,30
200903-011,2009-03-18,-1,2009-03-18 12:35:00,2009-03-18 13:30:00,5027,5067,-40
200903-012,2009-03-19,1,2009-03-19 12:00:00,2009-03-19 12:50:00,5104,5052,-52
200903-013,2009-03-19,-1,2009-03-19 12:55:00,2009-03-19 13:30:00,5034,5002,32
200903-014,2009-03-20,-1,2009-03-20 10:00:00,2009-03-20 13:30:00,4975,4941,34
200903-015,2009-03-23,1,2009-03-23 10:50:00,2009-03-23 13:30:00,5056,5115,59
200903-016,2009-03-24,1,2009-03-24 09:10:00,2009-03-24 13:30:00,5223,5248,25
200903-017,2009-03-25,1,2009-03-25 11:20:00,2009-03-25 13:30:00,5306,5356,50
200903-018,2009-03-26,1,2009-03-26 09:20:00,2009-03-26 10:45:00,5389,5335,-54
200903-019,2009-03-27,-1,2009-03-27 13:10:00,2009-03-27 13:30:00,5351,5369,-18
200903-020,2009-03-30,-1,2009-03-30 09:10:00,2009-03-30 13:30:00,5321,5145,176
200903-021,2009-03-31,-1,2009-03-31 13:20:00,2009-03-31 13:30:00,5190,5186,4
200904-001,2009-04-01,1,2009-04-01 09:20:00,2009-04-01 12:20:00,5295,5242,-53
200904-002,2009-04-02,1,2009-04-02 10:25:00,2009-04-02 13:30:00,5466,5508,42
200904-003,2009-04-06,1,2009-04-06 10:20:00,2009-04-06 13:10:00,5597,5541,-56
200904-004,2009-04-06,-1,2009-04-06 13:20:00,2009-04-06 13:30:00,5506,5531,-25
200904-005,2009-04-08,-1,2009-04-08 11:10:00,2009-04-08 13:30:00,5491,5445,46
200904-006,2009-04-09,1,2009-04-09 10:40:00,2009-04-09 13:30:00,5587,5694,107
200904-007,2009-04-10,1,2009-04-10 09:10:00,2009-04-10 09:55:00,5788,5730,-58
200904-008,2009-04-13,1,2009-04-13 09:45:00,2009-04-13 10:10:00,5847,5788,-59
200904-009,2009-04-13,1,2009-04-13 11:40:00,2009-04-13 13:30:00,5859,5851,-8
200904-010,2009-04-15,-1,2009-04-15 12:25:00,2009-04-15 13:30:00,5813,5861,-48
200904-011,2009-04-16,1,2009-04-16 09:50:00,2009-04-16 10:45:00,6034,5973,-61
200904-012,2009-04-17,-1,2009-04-17 11:50:00,2009-04-17 13:30:00,5950,5750,200
200904-013,2009-04-21,1,2009-04-21 12:35:00,2009-04-21 13:30:00,5815,5877,62
200904-014,2009-04-22,1,2009-04-22 09:10:00,2009-04-22 10:05:00,5899,5840,-59
200904-015,2009-04-23,-1,2009-04-23 09:10:00,2009-04-23 10:35:00,5824,5883,-59
200904-016,2009-04-24,-1,2009-04-24 12:20:00,2009-04-24 13:30:00,5850,5884,-34
200904-017,2009-04-27,-1,2009-04-27 10:10:00,2009-04-27 13:30:00,5791,5723,68
200904-018,2009-04-28,-1,2009-04-28 09:45:00,2009-04-28 10:45:00,5663,5720,-57
200904-019,2009-04-28,-1,2009-04-28 12:40:00,2009-04-28 13:30:00,5612,5610,2
200905-001,2009-05-11,1,2009-05-11 13:10:00,2009-05-11 13:30:00,6692,6625,-67
200905-002,2009-05-12,-1,2009-05-12 09:10:00,2009-05-12 13:30:00,6546,6447,99
200905-003,2009-05-14,-1,2009-05-14 09:10:00,2009-05-14 10:50:00,6335,6399,-64
200905-004,2009-05-15,1,2009-05-15 10:20:00,2009-05-15 13:30:00,6485,6500,15
200905-005,2009-05-18,1,2009-05-18 13:15:00,2009-05-18 13:30:00,6544,6548,4
200905-006,2009-05-19,1,2009-05-19 09:10:00,2009-05-19 12:40:00,6748,6680,-68
200905-007,2009-05-20,-1,2009-05-20 09:45:00,2009-05-20 10:40:00,6623,6690,-67
200905-008,2009-05-21,-1,2009-05-21 11:25:00,2009-05-21 13:30:00,6611,6665,-54
200905-009,2009-05-22,1,2009-05-22 11:00:00,2009-05-22 13:30:00,6719,6685,-34
200905-010,2009-05-25,1,2009-05-25 09:20:00,2009-05-25 09:35:00,6817,6748,-69
200905-011,2009-05-25,-1,2009-05-25 10:45:00,2009-05-25 11:45:00,6655,6722,-67
200905-012,2009-05-26,-1,2009-05-26 13:05:00,2009-05-26 13:30:00,6669,6654,15
200905-013,2009-05-27,1,2009-05-27 09:50:00,2009-05-27 13:30:00,6761,6987,226
200906-001,2009-06-02,-1,2009-06-02 12:55:00,2009-06-02 13:30:00,6962,6908,54
200906-002,2009-06-03,-1,2009-06-03 09:25:00,2009-06-03 13:30:00,6864,6882,-18
200906-003,2009-06-04,-1,2009-06-04 11:20:00,2009-06-04 13:30:00,6774,6763,11
200906-004,2009-06-06,1,2009-06-06 12:40:00,2009-06-06 13:30:00,6834,6849,15
200906-005,2009-06-08,-1,2009-06-08 09:35:00,2009-06-08 13:30:00,6778,6625,153
200906-006,2009-06-09,-1,2009-06-09 09:10:00,2009-06-09 13:30:00,6612,6409,203
200906-007,2009-06-11,-1,2009-06-11 09:30:00,2009-06-11 10:15:00,6352,6416,-64
200906-008,2009-06-11,1,2009-06-11 11:20:00,2009-06-11 13:30:00,6504,6525,21
200906-009,2009-06-12,-1,2009-06-12 12:20:00,2009-06-12 12:50:00,6423,6488,-65
200906-010,2009-06-15,-1,2009-06-15 09:10:00,2009-06-15 13:30:00,6314,6206,108
200906-011,2009-06-16,-1,2009-06-16 11:20:00,2009-06-16 11:35:00,6137,6199,-62
200906-012,2009-06-17,1,2009-06-17 09:45:00,2009-06-17 11:20:00,6278,6215,-63
200906-013,2009-06-18,-1,2009-06-18 09:50:00,2009-06-18 13:30:00,6112,6082,30
200906-014,2009-06-22,1,2009-06-22 11:20:00,2009-06-22 13:30:00,6160,6225,65
200906-015,2009-06-24,1,2009-06-24 11:30:00,2009-06-24 13:30:00,6236,6292,56
200906-016,2009-06-30,-1,2009-06-30 11:35:00,2009-06-30 13:30:00,6324,6368,-44
200907-001,2009-07-01,1,2009-07-01 11:35:00,2009-07-01 13:30:00,6450,6510,60
200907-002,2009-07-02,1,2009-07-02 09:15:00,2009-07-02 13:30:00,6548,6589,41
200907-003,2009-07-03,1,2009-07-03 11:05:00,2009-07-03 12:00:00,6626,6559,-67
200907-004,2009-07-03,-1,2009-07-03 12:05:00,2009-07-03 13:30:00,6532,6598,-66
200907-005,2009-07-07,1,2009-07-07 12:15:00,2009-07-07 13:30:00,6710,6681,-29
200907-006,2009-07-08,-1,2009-07-08 09:35:00,2009-07-08 13:30:00,6599,6609,-10
200907-007,2009-07-09,1,2009-07-09 09:15:00,2009-07-09 13:30:00,6710,6728,18
200907-008,2009-07-10,-1,2009-07-10 09:20:00,2009-07-10 12:35:00,6708,6740,-32
200907-009,2009-07-13,-1,2009-07-13 09:30:00,2009-07-13 13:30:00,6676,6478,198
200907-010,2009-07-14,1,2009-07-14 12:45:00,2009-07-14 13:30:00,6602,6596,-6
200907-011,2009-07-15,1,2009-07-15 09:20:00,2009-07-15 13:30:00,6673,6763,90
200907-012,2009-07-16,-1,2009-07-16 12:50:00,2009-07-16 13:30:00,6683,6687,-4
200907-013,2009-07-20,1,2009-07-20 11:15:00,2009-07-20 13:30:00,6861,6854,-7
200907-014,2009-07-23,-1,2009-07-23 09:10:00,2009-07-23 09:50:00,6850,6919,-69
200907-015,2009-07-24,-1,2009-07-24 13:15:00,2009-07-24 13:30:00,6881,6893,-12
200907-016,2009-07-27,1,2009-07-27 11:45:00,2009-07-27 13:30:00,6963,6965,2
200907-017,2009-07-28,1,2009-07-28 09:10:00,2009-07-28 13:30:00,7010,7066,56
200907-018,2009-07-29,-1,2009-07-29 11:35:00,2009-07-29 13:30:00,7047,7043,4
200907-019,2009-07-30,-1,2009-07-30 09:10:00,2009-07-30 13:30:00,7011,6955,56
200907-020,2009-07-31,1,2009-07-31 10:40:00,2009-07-31 13:05:00,7055,6984,-71
200907-021,2009-07-31,-1,2009-07-31 13:15:00,2009-07-31 13:30:00,6981,7007,-26
200908-001,2009-08-03,-1,2009-08-03 10:50:00,2009-08-03 13:05:00,6928,6990,-62
200908-002,2009-08-04,-1,2009-08-04 12:05:00,2009-08-04 13:30:00,6964,6878,86
200908-003,2009-08-05,-1,2009-08-05 12:15:00,2009-08-05 13:30:00,6847,6782,65
200908-004,2009-08-06,-1,2009-08-06 10:30:00,2009-08-06 11:55:00,6749,6817,-68
200908-005,2009-08-11,-1,2009-08-11 10:50:00,2009-08-11 12:30:00,6768,6808,-40
200908-006,2009-08-11,1,2009-08-11 13:15:00,2009-08-11 13:30:00,6854,6867,13
200908-007,2009-08-12,1,2009-08-12 09:30:00,2009-08-12 10:55:00,6895,6826,-69
200908-008,2009-08-13,1,2009-08-13 09:35:00,2009-08-13 13:30:00,6936,6997,61
200908-009,2009-08-14,1,2009-08-14 09:10:00,2009-08-14 13:30:00,7069,7048,-21
200908-010,2009-08-17,-1,2009-08-17 09:25:00,2009-08-17 13:30:00,6992,6921,71
200908-011,2009-08-18,-1,2009-08-18 11:05:00,2009-08-18 13:30:00,6841,6804,37
200908-012,2009-08-20,-1,2009-08-20 09:20:00,2009-08-20 12:20:00,6641,6700,-59
200908-013,2009-08-21,-1,2009-08-21 11:50:00,2009-08-21 13:30:00,6671,6609,62
200908-014,2009-08-24,1,2009-08-24 11:15:00,2009-08-24 13:30:00,6770,6796,26
200908-015,2009-08-25,-1,2009-08-25 13:20:00,2009-08-25 13:30:00,6745,6760,-15
200908-016,2009-08-26,-1,2009-08-26 09:20:00,2009-08-26 13:30:00,6725,6699,26
200908-017,2009-08-31,-1,2009-08-31 11:20:00,2009-08-31 13:00:00,6715,6758,-43
200909-001,2009-09-01,1,2009-09-01 09:20:00,2009-09-01 13:30:00,6808,7000,192
200909-002,2009-09-03,1,2009-09-03 10:30:00,2009-09-03 13:30:00,7058,7085,27
200909-003,2009-09-07,1,2009-09-07 09:50:00,2009-09-07 13:30:00,7195,7223,28
200909-004,2009-09-08,1,2009-09-08 10:15:00,2009-09-08 13:30:00,7251,7324,73
200909-005,2009-09-09,-1,2009-09-09 12:35:00,2009-09-09 13:30:00,7276,7274,2
200909-006,2009-09-14,-1,2009-09-14 09:20:00,2009-09-14 13:30:00,7304,7245,59
200909-007,2009-09-15,1,2009-09-15 11:50:00,2009-09-15 13:30:00,7344,7349,5
200909-008,2009-09-16,1,2009-09-16 09:10:00,2009-09-16 13:30:00,7428,7444,16
200909-009,2009-09-21,-1,2009-09-21 09:35:00,2009-09-21 13:30:00,7436,7470,-34
200909-010,2009-09-23,-1,2009-09-23 11:30:00,2009-09-23 13:30:00,7403,7360,43
200909-011,2009-09-28,-1,2009-09-28 09:45:00,2009-09-28 13:15:00,7275,7276,-1
200909-012,2009-09-29,1,2009-09-29 09:10:00,2009-09-29 13:30:00,7376,7396,20
200909-013,2009-09-30,1,2009-09-30 10:00:00,2009-09-30 13:30:00,7475,7483,8
200910-001,2009-10-01,-1,2009-10-01 11:15:00,2009-10-01 12:35:00,7464,7539,-75
200910-002,2009-10-02,-1,2009-10-02 13:10:00,2009-10-02 13:30:00,7380,7371,9
200910-003,2009-10-05,-1,2009-10-05 09:40:00,2009-10-05 13:15:00,7344,7374,-30
200910-004,2009-10-06,1,2009-10-06 10:05:00,2009-10-06 13:30:00,7475,7504,29
200910-005,2009-10-08,1,2009-10-08 09:10:00,2009-10-08 13:00:00,7610,7533,-77
200910-006,2009-10-08,-1,2009-10-08 13:05:00,2009-10-08 13:30:00,7502,7468,34
200910-007,2009-10-12,1,2009-10-12 13:00:00,2009-10-12 13:30:00,7590,7579,-11
200910-008,2009-10-13,1,2009-10-13 12:20:00,2009-10-13 13:30:00,7594,7571,-23
200910-009,2009-10-14,1,2009-10-14 09:15:00,2009-10-14 13:30:00,7624,7680,56
200910-010,2009-10-19,1,2009-10-19 10:45:00,2009-10-19 13:30:00,7732,7752,20
200910-011,2009-10-21,-1,2009-10-21 09:45:00,2009-10-21 13:30:00,7731,7706,25
200910-012,2009-10-22,-1,2009-10-22 09:55:00,2009-10-22 13:30:00,7601,7566,35
200910-013,2009-10-26,-1,2009-10-26 13:10:00,2009-10-26 13:30:00,7631,7642,-11
200910-014,2009-10-27,-1,2009-10-27 09:10:00,2009-10-27 12:00:00,7580,7627,-47
200910-015,2009-10-28,-1,2009-10-28 13:15:00,2009-10-28 13:30:00,7521,7522,-1
200910-016,2009-10-29,-1,2009-10-29 09:50:00,2009-10-29 13:30:00,7336,7341,-5
200911-001,2009-11-04,1,2009-11-04 09:20:00,2009-11-04 13:30:00,7349,7422,73
200911-002,2009-11-05,1,2009-11-05 10:40:00,2009-11-05 13:30:00,7443,7401,-42
200911-003,2009-11-11,-1,2009-11-11 09:30:00,2009-11-11 11:30:00,7572,7617,-45
200911-004,2009-11-11,1,2009-11-11 11:35:00,2009-11-11 13:30:00,7650,7677,27
200911-005,2009-11-12,1,2009-11-12 09:15:00,2009-11-12 13:30:00,7702,7674,-28
200911-006,2009-11-13,-1,2009-11-13 09:35:00,2009-11-13 10:30:00,7655,7692,-37
200911-007,2009-11-13,1,2009-11-13 10:35:00,2009-11-13 12:15:00,7711,7652,-59
200911-008,2009-11-13,-1,2009-11-13 12:20:00,2009-11-13 13:30:00,7631,7681,-50
200911-009,2009-11-16,1,2009-11-16 09:20:00,2009-11-16 13:30:00,7719,7798,79
200911-010,2009-11-17,-1,2009-11-17 10:20:00,2009-11-17 13:30:00,7751,7753,-2
200911-011,2009-11-19,-1,2009-11-19 09:10:00,2009-11-19 12:10:00,7721,7785,-64
200911-012,2009-11-20,-1,2009-11-20 10:25:00,2009-11-20 13:30:00,7666,7667,-1
200911-013,2009-11-25,1,2009-11-25 09:20:00,2009-11-25 13:30:00,7719,7762,43
200911-014,2009-11-26,1,2009-11-26 09:10:00,2009-11-26 13:30:00,7794,7754,-40
200911-015,2009-11-27,-1,2009-11-27 09:15:00,2009-11-27 13:30:00,7603,7456,147
200912-001,2009-12-01,-1,2009-12-01 09:35:00,2009-12-01 11:40:00,7551,7584,-33
200912-002,2009-12-01,1,2009-12-01 12:00:00,2009-12-01 13:30:00,7623,7648,25
200912-003,2009-12-02,1,2009-12-02 09:35:00,2009-12-02 13:30:00,7720,7673,-47
200912-004,2009-12-03,-1,2009-12-03 12:20:00,2009-12-03 13:30:00,7659,7689,-30
200912-005,2009-12-04,-1,2009-12-04 12:55:00,2009-12-04 13:30:00,7650,7623,27
200912-006,2009-12-07,1,2009-12-07 09:15:00,2009-12-07 13:30:00,7711,7767,56
200912-007,2009-12-08,-1,2009-12-08 10:30:00,2009-12-08 12:30:00,7722,7772,-50
200912-008,2009-12-09,1,2009-12-09 13:20:00,2009-12-09 13:30:00,7772,7770,-2
200912-009,2009-12-10,-1,2009-12-10 11:00:00,2009-12-10 13:30:00,7730,7643,87
200912-010,2009-12-11,1,2009-12-11 11:55:00,2009-12-11 13:30:00,7777,7784,7
200912-011,2009-12-14,1,2009-12-14 09:15:00,2009-12-14 09:25:00,7845,7766,-79
200912-012,2009-12-16,-1,2009-12-16 09:30:00,2009-12-16 12:45:00,7716,7780,-64
200912-013,2009-12-17,-1,2009-12-17 11:05:00,2009-12-17 13:30:00,7709,7703,6
200912-014,2009-12-21,1,2009-12-21 09:10:00,2009-12-21 13:30:00,7776,7760,-16
200912-015,2009-12-22,1,2009-12-22 10:50:00,2009-12-22 13:30:00,7817,7819,2
200912-016,2009-12-23,1,2009-12-23 12:00:00,2009-12-23 13:30:00,7863,7862,-1
200912-017,2009-12-24,1,2009-12-24 09:15:00,2009-12-24 13:30:00,7893,7940,47
200912-018,2009-12-28,1,2009-12-28 09:10:00,2009-12-28 13:30:00,7998,8055,57
200912-019,2009-12-29,-1,2009-12-29 09:55:00,2009-12-29 12:30:00,8027,8059,-32
200912-020,2009-12-30,1,2009-12-30 11:30:00,2009-12-30 13:30:00,8073,8091,18
200912-021,2009-12-31,1,2009-12-31 09:20:00,2009-12-31 13:30:00,8138,8192,54
201001-001,2010-01-04,-1,2010-01-04 09:55:00,2010-01-04 12:40:00,8123,8202,-79
201001-002,2010-01-05,1,2010-01-05 09:15:00,2010-01-05 10:05:00,8241,8158,-83
201001-003,2010-01-06,1,2010-01-06 11:00:00,2010-01-06 13:30:00,8275,8322,47
201001-004,2010-01-07,1,2010-01-07 09:20:00,2010-01-07 12:35:00,8349,8265,-84
201001-005,2010-01-07,-1,2010-01-07 12:55:00,2010-01-07 13:30:00,8258,8252,6
201001-006,2010-01-08,-1,2010-01-08 09:30:00,2010-01-08 11:10:00,8208,8288,-80
201001-007,2010-01-11,1,2010-01-11 11:15:00,2010-01-11 13:30:00,8347,8318,-29
201001-008,2010-01-12,-1,2010-01-12 11:10:00,2010-01-12 12:45:00,8262,8319,-57
201001-009,2010-01-13,-1,2010-01-13 09:50:00,2010-01-13 13:30:00,8225,8213,12
201001-010,2010-01-14,1,2010-01-14 11:35:00,2010-01-14 13:30:00,8278,8305,27
201001-011,2010-01-15,1,2010-01-15 09:10:00,2010-01-15 13:30:00,8336,8361,25
201001-012,2010-01-19,-1,2010-01-19 11:25:00,2010-01-19 13:30:00,8240,8268,-28
201001-013,2010-01-20,-1,2010-01-20 10:00:00,2010-01-20 13:30:00,8230,8215,15
201001-014,2010-01-21,-1,2010-01-21 09:20:00,2010-01-21 13:30:00,8176,8128,48
201001-015,2010-01-22,-1,2010-01-22 09:25:00,2010-01-22 13:30:00,7963,7901,62
201001-016,2010-01-26,-1,2010-01-26 10:15:00,2010-01-26 13:30:00,7824,7558,266
201001-017,2010-01-27,-1,2010-01-27 13:15:00,2010-01-27 13:30:00,7531,7537,-6
201001-018,2010-01-28,1,2010-01-28 10:35:00,2010-01-28 13:30:00,7638,7721,83
201001-019,2010-01-29,-1,2010-01-29 09:10:00,2010-01-29 10:45:00,7505,7581,-76
201002-001,2010-02-01,-1,2010-02-01 10:15:00,2010-02-01 13:30:00,7512,7533,-21
201002-002,2010-02-02,-1,2010-02-02 12:00:00,2010-02-02 13:30:00,7501,7401,100
201002-003,2010-02-05,-1,2010-02-05 09:20:00,2010-02-05 13:30:00,7269,7198,71
201002-004,2010-02-09,1,2010-02-09 09:45:00,2010-02-09 13:30:00,7235,7312,77
201002-005,2010-02-10,1,2010-02-10 09:25:00,2010-02-10 13:30:00,7428,7418,-10
201002-006,2010-02-23,-1,2010-02-23 09:10:00,2010-02-23 12:55:00,7503,7542,-39
201002-007,2010-02-25,-1,2010-02-25 09:25:00,2010-02-25 13:30:00,7471,7389,82
201003-001,2010-03-01,1,2010-03-01 09:55:00,2010-03-01 13:30:00,7462,7567,105
201003-002,2010-03-02,1,2010-03-02 09:45:00,2010-03-02 12:30:00,7647,7570,-77
201003-003,2010-03-03,1,2010-03-03 09:45:00,2010-03-03 13:30:00,7650,7611,-39
201003-004,2010-03-04,-1,2010-03-04 12:10:00,2010-03-04 13:30:00,7500,7531,-31
201003-005,2010-03-05,1,2010-03-05 09:45:00,2010-03-05 11:00:00,7685,7608,-77
201003-006,2010-03-08,1,2010-03-08 10:10:00,2010-03-08 13:30:00,7742,7748,6
201003-007,2010-03-10,-1,2010-03-10 10:20:00,2010-03-10 13:30:00,7741,7770,-29
201003-008,2010-03-11,-1,2010-03-11 10:55:00,2010-03-11 13:30:00,7737,7753,-16
201003-009,2010-03-15,-1,2010-03-15 09:50:00,2010-03-15 13:30:00,7709,7655,54
201003-010,2010-03-17,1,2010-03-17 09:10:00,2010-03-17 13:30:00,7768,7842,74
201003-011,2010-03-18,1,2010-03-18 12:15:00,2010-03-18 13:30:00,7910,7870,-40
201003-012,2010-03-19,-1,2010-03-19 09:15:00,2010-03-19 12:50:00,7845,7870,-25
201003-013,2010-03-22,-1,2010-03-22 09:10:00,2010-03-22 12:05:00,7821,7815,6
201003-014,2010-03-23,-1,2010-03-23 12:10:00,2010-03-23 13:30:00,7800,7798,2
201003-015,2010-03-25,-1,2010-03-25 09:15:00,2010-03-25 12:20:00,7780,7789,-9
201003-016,2010-03-26,-1,2010-03-26 09:20:00,2010-03-26 10:55:00,7729,7807,-78
201003-017,2010-03-26,1,2010-03-26 11:25:00,2010-03-26 13:30:00,7858,7869,11
201003-018,2010-03-29,1,2010-03-29 09:10:00,2010-03-29 13:30:00,7948,7953,5
201004-001,2010-04-01,1,2010-04-01 09:40:00,2010-04-01 13:30:00,7970,8018,48
201004-002,2010-04-06,1,2010-04-06 09:10:00,2010-04-06 13:30:00,8085,8083,-2
201004-003,2010-04-08,1,2010-04-08 10:25:00,2010-04-08 12:00:00,8150,8068,-82
201004-004,2010-04-08,-1,2010-04-08 12:15:00,2010-04-08 13:30:00,8059,8076,-17
201004-005,2010-04-13,-1,2010-04-13 09:10:00,2010-04-13 13:30:00,8062,8041,21
201004-006,2010-04-14,1,2010-04-14 13:20:00,2010-04-14 13:30:00,8108,8102,-6
201004-007,2010-04-15,1,2010-04-15 09:20:00,2010-04-15 13:30:00,8185,8160,-25
201004-008,2010-04-16,-1,2010-04-16 10:30:00,2010-04-16 13:30:00,8105,8099,6
201004-009,2010-04-19,-1,2010-04-19 09:50:00,2010-04-19 13:30:00,7998,7843,155
201004-010,2010-04-21,1,2010-04-21 09:10:00,2010-04-21 13:30:00,7950,7980,30
201004-011,2010-04-22,-1,2010-04-22 09:40:00,2010-04-22 12:40:00,7858,7915,-57
201004-012,2010-04-26,1,2010-04-26 09:15:00,2010-04-26 13:30:00,8095,8143,48
201004-013,2010-04-27,-1,2010-04-27 09:50:00,2010-04-27 11:55:00,8124,8147,-23
201004-014,2010-04-30,1,2010-04-30 09:20:00,2010-04-30 12:50:00,8132,8050,-82
201004-015,2010-04-30,-1,2010-04-30 13:05:00,2010-04-30 13:30:00,8032,7992,40
201005-001,2010-05-03,-1,2010-05-03 11:00:00,2010-05-03 13:30:00,7911,7933,-22
201005-002,2010-05-04,-1,2010-05-04 11:00:00,2010-05-04 13:30:00,7876,7918,-42
201005-003,2010-05-05,-1,2010-05-05 09:50:00,2010-05-05 13:30:00,7680,7670,10
201005-004,2010-05-06,-1,2010-05-06 10:20:00,2010-05-06 13:30:00,7621,7558,63
201005-005,2010-05-10,1,2010-05-10 12:35:00,2010-05-10 13:30:00,7600,7622,22
201005-006,2010-05-11,1,2010-05-11 09:10:00,2010-05-11 12:00:00,7670,7593,-77
201005-007,2010-05-11,-1,2010-05-11 12:55:00,2010-05-11 13:30:00,7572,7590,-18
201005-008,2010-05-12,-1,2010-05-12 12:50:00,2010-05-12 13:30:00,7562,7571,-9
201005-009,2010-05-13,1,2010-05-13 11:20:00,2010-05-13 13:30:00,7708,7756,48
201005-010,2010-05-17,-1,2010-05-17 09:15:00,2010-05-17 13:30:00,7656,7588,68
201005-011,2010-05-19,-1,2010-05-19 09:10:00,2010-05-19 12:20:00,7496,7553,-57
201005-012,2010-05-20,-1,2010-05-20 09:25:00,2010-05-20 13:30:00,7468,7391,77
201005-013,2010-05-21,-1,2010-05-21 09:10:00,2010-05-21 11:05:00,7153,7225,-72
201005-014,2010-05-25,-1,2010-05-25 09:50:00,2010-05-25 13:30:00,7121,7060,61
201005-015,2010-05-26,1,2010-05-26 13:05:00,2010-05-26 13:30:00,7150,7125,-25
201005-016,2010-05-27,1,2010-05-27 11:25:00,2010-05-27 13:30:00,7172,7216,44
201005-017,2010-05-28,1,2010-05-28 09:25:00,2010-05-28 12:50:00,7299,7226,-73
201006-001,2010-06-02,-1,2010-06-02 12:40:00,2010-06-02 13:30:00,7157,7150,7
201006-002,2010-06-03,1,2010-06-03 09:10:00,2010-06-03 13:30:00,7290,7328,38
201006-003,2010-06-07,-1,2010-06-07 09:10:00,2010-06-07 13:30:00,7073,7103,-30
201006-004,2010-06-09,-1,2010-06-09 11:20:00,2010-06-09 13:30:00,7071,7040,31
201006-005,2010-06-10,1,2010-06-10 12:35:00,2010-06-10 13:30:00,7139,7145,6
201006-006,2010-06-14,1,2010-06-14 11:30:00,2010-06-14 13:30:00,7378,7380,2
201006-007,2010-06-15,1,2010-06-15 11:05:00,2010-06-15 13:30:00,7411,7460,49
201006-008,2010-06-17,1,2010-06-17 10:50:00,2010-06-17 13:30:00,7524,7519,-5
201006-009,2010-06-18,-1,2010-06-18 09:10:00,2010-06-18 13:30:00,7358,7340,18
201006-010,2010-06-21,1,2010-06-21 11:25:00,2010-06-21 13:30:00,7509,7508,-1
201006-011,2010-06-23,-1,2010-06-23 09:10:00,2010-06-23 13:30:00,7418,7427,-9
201006-012,2010-06-25,-1,2010-06-25 11:50:00,2010-06-25 13:30:00,7328,7329,-1
201006-013,2010-06-29,-1,2010-06-29 10:45:00,2010-06-29 13:30:00,7345,7278,67
201006-014,2010-06-30,-1,2010-06-30 09:25:00,2010-06-30 12:15:00,7106,7155,-49
201007-001,2010-07-01,-1,2010-07-01 09:15:00,2010-07-01 13:30:00,7114,7101,13
201007-002,2010-07-02,1,2010-07-02 10:20:00,2010-07-02 13:30:00,7168,7155,-13
201007-003,2010-07-05,1,2010-07-05 10:45:00,2010-07-05 13:30:00,7216,7278,62
201007-004,2010-07-06,1,2010-07-06 10:10:00,2010-07-06 13:30:00,7325,7435,110
201007-005,2010-07-09,1,2010-07-09 11:35:00,2010-07-09 13:30:00,7571,7575,4
201007-006,2010-07-14,1,2010-07-14 09:50:00,2010-07-14 13:30:00,7695,7692,-3
201007-007,2010-07-15,1,2010-07-15 10:10:00,2010-07-15 13:30:00,7713,7708,-5
201007-008,2010-07-16,-1,2010-07-16 09:50:00,2010-07-16 13:30:00,7648,7677,-29
201007-009,2010-07-20,1,2010-07-20 11:40:00,2010-07-20 13:30:00,7694,7722,28
201007-010,2010-07-21,-1,2010-07-21 12:25:00,2010-07-21 13:30:00,7701,7687,14
201007-011,2010-07-22,-1,2010-07-22 09:35:00,2010-07-22 13:30:00,7551,7567,-16
201007-012,2010-07-23,1,2010-07-23 12:15:00,2010-07-23 13:30:00,7689,7691,2
201007-013,2010-07-26,1,2010-07-26 09:55:00,2010-07-26 13:30:00,7722,7708,-14
201007-014,2010-07-27,-1,2010-07-27 10:05:00,2010-07-27 13:30:00,7666,7659,7
201007-015,2010-07-28,1,2010-07-28 12:25:00,2010-07-28 13:30:00,7700,7721,21
201007-016,2010-07-29,-1,2010-07-29 11:15:00,2010-07-29 11:55:00,7683,7724,-41
201007-017,2010-07-30,-1,2010-07-30 09:20:00,2010-07-30 13:30:00,7663,7669,-6
201008-001,2010-08-02,1,2010-08-02 09:20:00,2010-08-02 13:30:00,7798,7859,61
201008-002,2010-08-04,-1,2010-08-04 11:50:00,2010-08-04 13:30:00,7875,7913,-38
201008-003,2010-08-05,-1,2010-08-05 12:05:00,2010-08-05 13:30:00,7894,7905,-11
201008-004,2010-08-09,1,2010-08-09 09:20:00,2010-08-09 13:30:00,7947,7987,40
201008-005,2010-08-10,-1,2010-08-10 09:40:00,2010-08-10 13:30:00,7971,7950,21
201008-006,2010-08-11,-1,2010-08-11 09:55:00,2010-08-11 13:30:00,7881,7856,25
201008-007,2010-08-12,-1,2010-08-12 09:50:00,2010-08-12 13:30:00,7768,7810,-42
201008-008,2010-08-13,1,2010-08-13 12:20:00,2010-08-13 13:30:00,7887,7897,10
201008-009,2010-08-16,1,2010-08-16 12:20:00,2010-08-16 13:30:00,7925,7944,19
201008-010,2010-08-17,1,2010-08-17 09:20:00,2010-08-17 13:30:00,7957,7954,-3
201008-011,2010-08-18,-1,2010-08-18 11:50:00,2010-08-18 13:30:00,7905,7919,-14
201008-012,2010-08-19,-1,2010-08-19 09:10:00,2010-08-19 11:55:00,7877,7908,-31
201008-013,2010-08-20,-1,2010-08-20 10:50:00,2010-08-20 13:30:00,7865,7887,-22
201008-014,2010-08-24,-1,2010-08-24 09:50:00,2010-08-24 11:35:00,7905,7956,-51
201008-015,2010-08-24,-1,2010-08-24 13:00:00,2010-08-24 13:30:00,7893,7911,-18
201008-016,2010-08-25,-1,2010-08-25 09:10:00,2010-08-25 13:30:00,7812,7695,117
201008-017,2010-08-26,-1,2010-08-26 09:55:00,2010-08-26 11:50:00,7661,7695,-34
201008-018,2010-08-30,1,2010-08-30 10:25:00,2010-08-30 12:25:00,7775,7697,-78
201008-019,2010-08-31,-1,2010-08-31 09:30:00,2010-08-31 13:30:00,7613,7546,67
201009-001,2010-09-01,1,2010-09-01 12:55:00,2010-09-01 13:30:00,7628,7629,1
201009-002,2010-09-02,1,2010-09-02 09:15:00,2010-09-02 13:30:00,7716,7697,-19
201009-003,2010-09-03,1,2010-09-03 09:15:00,2010-09-03 13:30:00,7744,7772,28
201009-004,2010-09-06,1,2010-09-06 09:55:00,2010-09-06 13:30:00,7862,7863,1
201009-005,2010-09-09,-1,2010-09-09 12:40:00,2010-09-09 13:30:00,7808,7834,-26
201009-006,2010-09-13,1,2010-09-13 09:20:00,2010-09-13 13:30:00,7954,8094,140
201009-007,2010-09-14,1,2010-09-14 10:20:00,2010-09-14 13:30:00,8119,8129,10
201009-008,2010-09-15,1,2010-09-15 13:10:00,2010-09-15 13:30:00,8152,8154,2
201009-009,2010-09-16,-1,2010-09-16 11:45:00,2010-09-16 13:30:00,8117,8082,35
201009-010,2010-09-17,1,2010-09-17 11:00:00,2010-09-17 13:30:00,8163,8167,4
201009-011,2010-09-21,-1,2010-09-21 10:45:00,2010-09-21 13:30:00,8167,8190,-23
201009-012,2010-09-24,-1,2010-09-24 09:30:00,2010-09-24 13:30:00,8162,8157,5
201009-013,2010-09-28,-1,2010-09-28 09:20:00,2010-09-28 10:50:00,8153,8199,-46
201009-014,2010-09-29,1,2010-09-29 12:00:00,2010-09-29 13:30:00,8286,8228,-58
201009-015,2010-09-30,-1,2010-09-30 10:10:00,2010-09-30 13:30:00,8203,8207,-4
201010-001,2010-10-04,1,2010-10-04 09:20:00,2010-10-04 13:30:00,8256,8223,-33
201010-002,2010-10-05,-1,2010-10-05 09:20:00,2010-10-05 13:30:00,8191,8185,6
201010-003,2010-10-06,1,2010-10-06 09:10:00,2010-10-06 13:30:00,8278,8274,-4
201010-004,2010-10-11,-1,2010-10-11 09:20:00,2010-10-11 13:30:00,8213,8142,71
201010-005,2010-10-12,-1,2010-10-12 09:15:00,2010-10-12 13:30:00,8130,8051,79
201010-006,2010-10-14,1,2010-10-14 09:35:00,2010-10-14 13:30:00,8205,8206,1
201010-007,2010-10-15,-1,2010-10-15 12:25:00,2010-10-15 13:30:00,8203,8204,-1
201010-008,2010-10-18,-1,2010-10-18 09:10:00,2010-10-18 13:30:00,8168,8062,106
201010-009,2010-10-20,1,2010-10-20 11:00:00,2010-10-20 13:30:00,8080,8120,40
201010-010,2010-10-21,1,2010-10-21 09:25:00,2010-10-21 13:30:00,8121,8105,-16
201010-011,2010-10-25,1,2010-10-25 09:15:00,2010-10-25 13:30:00,8178,8299,121
201010-012,2010-10-26,1,2010-10-26 12:50:00,2010-10-26 13:30:00,8338,8320,-18
201010-013,2010-10-27,-1,2010-10-27 09:40:00,2010-10-27 13:30:00,8301,8282,19
201010-014,2010-10-28,1,2010-10-28 13:15:00,2010-10-28 13:30:00,8347,8350,3
201010-015,2010-10-29,-1,2010-10-29 10:50:00,2010-10-29 13:30:00,8288,8290,-2
201011-001,2010-11-01,1,2010-11-01 09:10:00,2010-11-01 13:30:00,8375,8396,21
201011-002,2010-11-02,-1,2010-11-02 09:50:00,2010-11-02 13:30:00,8375,8369,6
201011-003,2010-11-03,-1,2010-11-03 09:40:00,2010-11-03 13:30:00,8361,8304,57
201011-004,2010-11-08,-1,2010-11-08 10:10:00,2010-11-08 13:30:00,8445,8442,3
